10-krona|10-kronor
100-lapp|100-lappar
1000-lapp|1000-lappar
20-kronorssedel|20-kronorssedlar
20-lapp|20-lappar
5-krona|5-kronor
50-öring|50-öringar
å|åar
A-aktie|A-aktier
A-lagare|A-lagare
A-traktor|A-traktorer
abbé|abbéer
abbedissa|abbedissor
abborre|abborrar
abborrsoppa|abborresoppor
abbot|abbotar
abbotsdöme|abbotsdömen
abbreviation|abbreviationer
abbreviator|abbreviatorer
ABC-bok|ABC-böcker
abchazier|abchazier
abderit|abderiter
abdikation|abdikationer
aber|aber
aberration|aberrationer
abessinier|abessinier
abilitet|abiliteter
abiogenes|abiogeneser
abiturient|abiturienter
ablation|ablationer
ablativ|ablativer
abnormitet|abnormiteter
abolition|abolitioner
abolitionism|abolitionismer
abolitionist|abolitionister
abonnemang|abonnemang
abonnemangsdag|abonnemangsdagar
abonnent|abonnenter
aborigin|aboriginer
abort|aborter
abortör|abortörer
abrasion|abrasioner
abrovink|abrovinker
abrovinsch|abrovinscher
abscess|abscesser
absens|absenser
absid|absider
absolutbelopp|absolutbelopp
absolution|absolutioner
absolutism|absolutismer
absolutist|absolutister
absorption|absorptioner
abstinens|abstinenser
abstinensbesvär|abstinensbesvär
abstract|abstracts
abstraktion|abstraktioner
absurditet|absurditeter
abundans|abundanser
acceleration|accelerationer
accelerator|acceleratorer
accent|accenter
accentuering|accentueringar
accept|accepter
acceptans|acceptanser
acceptant|acceptanter
access|accesser
accession|accessioner
accessionskatalog|accessionskataloger
accessit|accessit
accessoar|accessoarer
accesstid|accesstider
accis|acciser
accompagnato|accompagnaton
acetat|acetater
aceton|acetoner
acetyl|acetyler
acetylen|acetylener
aciditet|aciditeter
äckel|äckel
acklimatisering|acklimatiseringar
ackolad|ackolader
ackommodation|ackommodationer
ackommodationsförmåga|ackommodationsförmågor
ackommodationsväxel|ackommodationsväxlar
ackompanjatör|ackompanjatörer
ackompanjatris|ackompanjatriser
ackompanjemang|ackompanjemang
ackompanjemangsinstrument|ackompanjemangsinstrument
ackord|ackord
ackordeon|ackordeon
ackumulation|ackumulationer
ackumulator|ackumulatorer
ackusativ|ackusativer
ackuschör|ackuschörer
ackuschörska|ackusörskor
ackvisition|ackvisitioner
ackvisitör|ackvisitörer
action|actions
actionfilm|actionfilmer
adagietto|adagietton
adagio|adagion
adamsäpple|adamsäpplen
adaptation|adaptationer
adapter|adaptrar
adaption|adaptioner
addend|addender
additament|additament
addition|additioner
ädelgas|ädelgaser
ädellövskog|ädellövskogar
ädellövträd|ädellövträd
adelsdam|adelsdamer
adelskap|adelskap
adelsman|adelsmän
ädelsten|ädelstenar
adenit|adeniter
adept|adepter
adertondedel|adertondedelar
adertondel|adertondelar
adjektiv|adjektiv
adjektivform|adjektivformer
adjektivsjuka|adjektivsjukor
adjunkt|adjunkter
adjutant|adjutanter
admin|adminer
administration|administrationer
administratör|administratörer
administratörskap|administratörskap
admittans|admittanser
adolescens|adolescenser
adoption|adoptioner
adoptivbarn|adoptivbarn
adposition|adpositioner
adress|adresser
adressat|adressater
adventsljusstake|adventsljusstakar
adverb|adverb
adverbform|adverbformer
adverbial|adverbial
advokat|advokater
aerofobi|aerofobier
affär|affärer
affärstransaktion|affärstransaktioner
affektation|affektationer
affektion|affektioner
affektionsvärde|affektionsvärden
affinitet|affiniteter
affisch|affischer
affischpelare|affischpelare
affix|affix
affrikata|affrikator
afghan|afghaner
afghanska|afghanskor
aforism|aforismer
afrikan|afrikaner
afrikanska|afrikanskor
afseende|afseenden
afton|aftnar
aftonfalk|aftonfalkar
aftonstjärna|aftonstjärnor
ag|agar
aga|agar
äga|ägor
ägare|ägare
agat|agater
agenda|agendor
agent|agenter
agentur|agenturer
ägg|ägg
äggcell|äggceller
äggisolator|äggisolatorer
äggklocka|äggklockor
äggkopp|äggkoppar
äggmök|äggmökar
aggregat|aggregat
aggregationstillstånd|aggregationstillstånd
aggression|aggressioner
äggskal|äggskal
äggula|äggulor
äggvita|äggvitor
äggviteämne|äggviteämnen
agitator|agitatorer
agnostiker|agnostiker
ägretthäger|ägretthägrar
agronom|agronomer
åhörare|åhörare
aidatrumpet|aidatrumpeter
ailurofobi|ailurofobier
åk|åk
akademi|akademier
akademiker|akademiker
akademiledamot|akademiledamoter
åkarbrasa|åkarebrasor
åkdon|åkdon
åker|åkrar
åkerspöke|åkerspöken
akilleshäl|akilleshälar
åklagare|åklagare
akleja|aklejor
åkomma|åkommor
akribi|akribier
akrobat|akrobater
akrofobi|akrofobier
akronym|akronymer
akt|akter
äktenskap|äktenskap
akter|aktrar
aktersnurra|aktersnurror
aktie|aktier
aktieägare|aktieägare
aktiebolag|aktiebolag
aktion|aktioner
aktivist|aktivister
aktivitet|aktiviteter
aktivitetsfält|aktivitetsfält
aktör|aktörer
aktris|aktriser
aktualitet|aktualiteter
akustik|akustiker
akustiker|akustiker
akvarell|akvareller
akvarellmålare|akvarellmålare
akvarist|akvarister
akvarium|akvarier
akvedukt|akvedukter
al|alar
ål|ålar
alan|alaner
åländska|åländskor
ålänning|ålänningar
alban|albaner
albanienresa|albanienresor
albanska|albanskor
albatross|albatrossar
albino|albiner
album|album
aldehyd|aldehyder
ålder|åldrar
ålderman|åldermän
åldring|åldringar
ale|aler
älf|älfvar
alfa|alfa
alfabet|alfabet
alfågel|alfåglar
alförrädare|alförrädare
alg|alger
älg|älgar
algebra|algebror
algebraiker|algebraiker
algerier|algerier
algeriska|algeriskor
älgfluga|älgflugor
älgkramare|älgkramare
algofobi|algofobier
algoritm|algoritmer
alibi|alibin
alienation|alienationer
åliggande|åligganden
alika|alikor
alingsåsare|alingsåsare
alka|alkor
alkalie|alkalier
alkalimetall|alkalimetaller
alkan|alkaner
alkekung|alkekungar
alkemist|alkemister
alken|alkener
alkis|alkisar
alkohol|alkoholer
alkoholhalt|alkoholhalter
alkoholist|alkoholister
alkov|alkover
alkyn|alkyner
all-in|all-in
allätare|allätare
allé|alléer
allegori|allegorier
allemansrätt|allemansrätter
allergi|allergier
allergiker|allergiker
allians|allianser
alligator|alligatorer
alligatorägg|alligatorägg
älling|ällingar
allitteration|allitterationer
allmänintresse|allmänintressen
allofon|allofoner
allomorf|allomorfer
allsvenska|allsvenskor
allusion|allusioner
allvar|allvar
alm|almar
aln|alnar
alp|alper
alphorn|alphorn
alpjärnsparv|alpjärnsparvar
alpseglare|alpseglare
älskare|älskare
älskling|älsklingar
alster|alster
alt|altar
altan|altaner
altare|altare
altarskåp|altarskåp
altarskrank|altarskrankar
altartavla|altartavlor
altbasun|altbasuner
altflöjt|altflöjter
althorn|althorn
altklarinett|altklarinetter
altoboe|altoboer
altruist|altruister
altviolin|altvioliner
aluminiumburk|aluminiumburkar
aluminiumfolie|aluminiumfolier
alumn|alumner
älv|älvar
älva|älvor
alveol|alveoler
älvsik|älvsikar
amatris|amatriser
ambassad|ambassader
ambassadör|ambassadörer
ämbete|ämbeten
ämbetsman|ämbetsmän
ambiguitet|ambiguiteter
ambition|ambitioner
ambivalensacceptans|ambivalensacceptanser
ambulans|ambulanser
ambulatorium|ambulatoria
amerikan|amerikaner
amerikanare|amerikanare
amerikanska|amerikanskor
amfibie|amfibier
amfiteater|amfiteatrar
amfora|amforor
amid|amider
amin|aminer
aminosyra|aminosyror
amiral|amiraler
amma|ammor
ammoniumjon|ammoniumjoner
ämne|ämnen
ämnesområde|ämnesområden
amnesti|amnestier
amöba|amöbor
amoralitet|amoraliteter
amortering|amorteringar
amortissemang|amortissemanger
amortissement|amortissementer
ampere|ampere
amperetimme|amperetimmar
amplifikation|amplifikationer
amplitud|amplituder
amputation|amputationer
amsaga|amsagor
amulett|amuletter
anagram|anagram
anakonda|anakondor
anakronism|anakronismer
analfabet|analfabeter
analogi|analogier
analys|analyser
analysmetod|analysmetoder
analytiker|analytiker
ananasmaska|ananasmaskor
ananassorbet|ananassorbeter
anarki|anarkier
anarkism|anarkismer
anarkist|anarkister
anatomi|anatomier
anblick|anblickar
anbud|anbud
and|änder
ånd|ånder
anda|andor
ända|ändor
ändalykt|ändalykter
ändamål|ändamål
ande|andar
ände|ändar
andedräkt|andedräkter
andel|andelar
ändelse|ändelser
andhane|andhanar
andhanne|andhannar
andhona|andhonor
andningsstillestånd|andningsstillestånd
andorran|andorraner
andorranska|andorranskor
andraderivata|andraderivator
andragradspolynom|andragradspolynom
andrahandsvara|andrahandsvaror
andrake|andrakar
ändring|ändringar
androfobi|androfobier
android|androider
anekdot|anekdoter
anfader|anfäder
anfall|anfall
anfallare|anfallare
anfang|anfanger
anförare|anförare
äng|ängar
ångare|ångare
ångbåt|ångbåtar
angel|angels
ängel|änglar
angelägenhet|angelägenheter
ångfartyg|ångfartyg
änglaförälder|änglaföräldrar
anglicism|anglicismer
anglofil|anglofiler
ångmaskin|ångmaskiner
angolan|angolaner
angrepp|angrepp
ängshök|ängshökar
ängsmaskros|ängsmaskrosor
ängspiplärka|ängspiplärkor
anhängare|anhängare
animering|animeringar
aning|aningar
anjon|anjoner
anka|ankor
änka|änkor
ankare|ankare
änkefru|änkefruar
änkestöt|änkestötar
änkling|änklingar
anknytning|anknytningar
ankomst|ankomster
ankomsttid|ankomsttider
anläggning|anläggningar
anledning|anledningar
anlete|anleten
anmärkning|anmärkningar
anmodan|anmodanden
annex|annex
annons|annonser
annonsör|annonsörer
annonssida|annonssidor
annuell|annueller
annullering|annulleringar
annulus|annulusar
anod|anoder
anomali|anomalier
anor|anor
anrättning|anrättningar
ansats|ansatser
ansibel|ansiblar
ansikte|ansikten
anskrämlighet|anskrämligheter
anslag|anslag
anslutning|anslutningar
ansökan|ansökningar
anspråk|anspråk
anställning|anställningar
anstånd|anstånd
anständighetsskäl|anständighetsskäl
ansträngning|ansträngningar
anstrykning|anstrykningar
antagande|antaganden
antagningsbesked|antagningsbesked
antal|antal
anteckning|anteckningar
anteckningsblock|anteckningsblock
anteckningsbok|anteckningsböcker
antiderivata|antiderivator
antiklimax|antiklimaxar
antikva|antikvor
antikvark|antikvarkar
antilop|antiloper
antipartikel|antipartiklar
antipod|antipoder
antirasist|antirasister
antologi|antologier
antonym|antonymer
anus|anus
användare|användare
användarnamn|användarnamn
användarprofil|användarprofiler
användarsida|användarsidor
användning|användningar
användningsområde|användningsområden
aorta|aortor
apa|apor
apart|aparter
apel|aplar
apelsin|apelsiner
apelsindryck|apelsindrycker
apelsinjuice|apelsinjuicer
apelsinkräm|apelsinkrämer
apelsinmarmelad|apelsinmarmelader
apelsinsaft|apelsinsafter
apelsinsorbet|apelsinsorbeter
apelsinträd|apelsinträd
apnäve|apnävar
apostel|apostlar
apostlahästar|apostlahästar
apotek|apotek
apothekare|apothekare
apparat|apparater
äppeljuice|äppeljuicer
äppelkärna|äppelkärnor
äppelknyckarbyxa|äppelknyckarbyxor
äppelkompott|äppelkompotter
appell|appeller
äppelpaj|äppelpajer
äppelskal|äppelskal
äppelträd|äppelträd
appendix|appendix
äpple|äpplen
äpplekräm|äpplekrämer
äppleträd|äppleträd
applikation|applikationer
approximant|approximanter
approximation|approximationer
aprikos|aprikoser
aprikoskärna|aprikoskärnor
aprikoskompott|aprikoskompotter
aprikoskräm|aprikoskrämer
aprikosmarmelad|aprikosmarmelader
april|aprilmånader
aprilskämt|aprilskämt
år|år
ara|aror
åra|åror
ära|äror
arab|araber
arabesk|arabesker
arabiska|arabiskor
arabkramare|arabkramar
araknofobi|araknofobier
arbetare|arbetare
arbete|arbeten
arbetsdag|arbetsdagar
arbetsförmedling|arbetsförmedlingar
arbetsgivare|arbetsgivare
arbetshäst|arbetshästar
arbetskamrat|arbetskamrater
arbetsmarknad|arbetsmarknader
arbetsmarknadsminister|arbetsmarknadsministrar
arbetsmiljö|arbetsmiljöer
arbetsminne|arbetsminnen
arbetsmyra|arbetsmyror
arbetsnarkoman|arbetsnarkomaner
arbetsplats|arbetsplatser
arbetsrätt|arbetsrätter
arbetsställning|arbetsställningar
arbetsstycke|arbetsstycken
arbetstagare|arbetstagare
arbetstid|arbetstider
arbetstillfälle|arbetstillfällen
arbetsvecka|arbetsveckor
arborist|arborister
area|areor
arena|arenor
ärende|ärenden
areol|areoler
Åreresa|Åreresor
arête|arêten
arf|arf
arfvinge|arfvingar
argentinare|argentinare
argentinska|argentinskor
argument|argument
argumentation|argumentationer
århundrade|århundraden
ärkefiende|ärkefiender
arkipelag|arkipelager
arkitekt|arkitekter
arkitektur|arkitekturer
arkiv|arkiv
arm|armar
ärm|ärmar
armbåge|armbågar
armbågsben|armbågsben
armband|armband
armbandsklocka|armbandsklockor
armbandsur|armbandsur
armborst|armborst
armé|arméer
armenier|armenier
armeniska|armeniskor
armmuskel|armmuskler
arom|aromer
ärr|ärr
arrangemang|arrangemang
arrangör|arrangörer
arrendator|arrendatorer
ars|arsar
arshål|arshål
årshögtid|årshögtider
årsskifte|årsskiften
årstid|årstider
art|arter
ärt|ärter
årta|årtor
ärta|ärtor
artär|artärer
artbestämning|artbestämningar
artefakt|artefakter
artikel|artiklar
artist|artister
artondedel|artondedelar
artondel|artondelar
ärtsoppa|ärtsoppor
arv|arv
arvedel|arvedelar
arvinge|arvingar
arvode|arvoden
arvslott|arvslotter
arytmi|arytmier
as|as
ås|åsar
asätare|asätare
asiat|asiater
asienresa|asienresor
åsikt|åsikter
åsiktsmotståndare|åsiktsmotståndare
ask|askar
aska|askor
åskådare|åskådare
åskådning|åskådningar
asket|asketer
askfat|askfat
åskknall|åskknallar
askkopp|askkoppar
askmoln|askmoln
åskmoln|åskmoln
åskvigg|åskviggar
åsna|åsnor
asp|aspar
aspekt|aspekter
äsping|äspingar
aspiration|aspirationer
aspirationspneumoni|aspirationspneumonier
aspsik|aspsikar
aspskog|aspskogar
ass|ass
äss|äss
assegaj|assegajer
assessorska|assessorskor
assiett|assietter
assistent|assistenter
astenosfär|astenosfärer
aster|astrar
asterisk|asterisker
asteroid|asteroider
asteroidbälte|asteroidbälten
astrobiolog|astrobiologer
astrofysiker|astrofysiker
astrolog|astrologer
astronaut|astronauter
astronom|astronomer
asyl|asyler
asynja|asynjor
åtbörd|åtbörder
ateist|ateister
åtel|åtlar
ateljé|ateljéer
återanvändning|återanvändningar
återbesök|återbesök
återhämtning|återhämtningar
återhöjning|återhöjningar
återställningstecken|återställningstecken
återstod|återstoder
återtåg|återtåg
återvändsgränd|återvändsgränder
återvinningsstation|återvinningsstationer
åtgärd|åtgärder
åtgörande|åtgöranden
atlantmaskros|atlantmaskrosor
atlas|atlaser
atlet|atleter
atmosfär|atmosfärer
atom|atomer
atombomb|atombomber
atombombning|atombombningar
atomgrupp|atomgrupper
atomkärna|atomkärnor
atommassa|atommassor
atomnummer|atomnummer
atomslag|atomslag
åtsida|åtsidor
ätt|ätter
åtta|åttor
attack|attacker
åttahörning|åttahörningar
attentat|attentat
attityd|attityder
ättling|ättlingar
åttondedel|åttondedelar
åttondel|åttondelar
attribut|attribut
aubergine|auberginer
audiofil|audiofiler
audionom|audionomer
augusti|augustimånader
auktion|auktioner
auktor|auktorer
auktoritet|auktoriteter
auktorsförkortning|auktorsförkortningar
aula|aulor
aulos|auloi
aura|auror
australiensare|australiensare
australiensiska|australiensiskor
australier|australier
australiska|australiskor
autentisering|autentiseringar
auto|autot
autoantonym|autoantonymer
autofobi|autofobier
autograf|autografer
autokrati|autokratier
automat|automater
automorfi|automorfier
automorfism|automorfismer
autonomi|autonomier
autopilot|autopiloter
autostart|autostarter
autostrada|autostrador
avantgarde|avantgarden
avatar|avatarer
avbildning|avbildningar
avbrott|avbrott
avdelning|avdelningar
avdrag|avdrag
avdragare|avdragare
avdragsschack|avdragsschackar
äventyr|äventyr
aversion|aversioner
avfall|avfall
avfälling|avfällingar
avfångningsskott|avfångningsskott
avfärd|avfärder
avfart|avfarter
avgång|avgångar
avgångstid|avgångstider
avgas|avgaser
avgasrör|avgasrör
avgift|avgifter
avgränsning|avgränsningar
avgrund|avgrunder
avhandling|avhandlingar
aviga|avigor
avigsida|avigsidor
avis|aviser
avisa|avisor
avkastning|avkastningar
avkrok|avkrokar
avledning|avledningar
avrättning|avrättningar
avrinningsområde|avrinningsområden
avsändare|avsändare
avseende|avseenden
avsidesreplik|avsidesrepliker
avsikt|avsikter
avskräde|avskräden
avslag|avslag
avslöjande|avslöjanden
avsnitt|avsnitt
avspark|avsparkar
avspärrning|avspärrningar
avstånd|avstånd
avstavning|avstavningar
avsugning|avsugningar
avtal|avtal
avtoning|avtoningar
avtryck|avtryck
avundsjuka|avundsjukor
avvägningsinstrument|avvägningsinstrument
ax|ax
axel|axlar
axelremsväska|axelremsväskor
axelväska|axelväskor
axiom|axiom
axplock|axplock
azer|azerer
azerbajdzjanska|azerbajdzjanskor
azerier|azerier
azeriska|azeriskor
azimut|azimuter
aztekiska|aztekiskor
aztekkaktus|aztekkaktusar
azukiböna|azukibönor
azurmes|azurmesar
B-aktie|B-aktier
b-förtecken|b-förtecken
B-vitamin|B-vitaminer
bábí|bábíer
bäbis|bäbisar
baby|babyar
bacillusk|bacillusker
back|backar
bäck|bäckar
backanal|backanaler
backe|backar
bäcken|bäcken
backspegel|backspeglar
backsvala|backsvalor
bad|bad
bädd|bäddar
baddare|baddare
badkar|badkar
badkruka|badkrukor
badmintonspelare|badmintonspelare
badrock|badrockar
bådskap|bådskap
badvakt|badvakter
bag|bagar
bagare|bagare
bagatell|bagateller
båge|bågar
baggböleri|baggbölerier
bagge|baggar
baggis|baggisar
bågminut|bågminuter
bågsekund|bågsekunder
baguette|baguetter
bahá'í|bahá'íer
baisse|baisser
bajamaja|bajamajor
bajskorv|bajskorvar
bajslåda|bajslådor
bak|bakar
bakgrund|bakgrunder
bakgrundsbild|bakgrundsbilder
bakgrundsljud|bakgrundsljud
bakplåt|bakplåtar
bakplåtspapper|bakplåtspapper
baksäte|baksäten
baksida|baksidor
baksmälla|baksmällor
baktanke|baktankar
bakterie|bakterier
bakverk|bakverk
bal|balar
bål|bålar
balalajka|balalajkor
balans|balanser
balanssinne|balanssinnen
balansvåg|balansvågar
baldakin|baldakiner
balett|baletter
balettkompani|balettkompanier
balettsko|balettskor
balja|baljor
balk|balkar
balkanisering|balkaniseringar
balklänning|balklänningar
balkong|balkonger
balkonglåda|balkonglådor
ball|ballar
ballad|ballader
balle|ballar
ballongfärd|ballongfärder
bamburör|bamburör
bana|banor
Banachrum|Banachrum
banan|bananer
bananrepublik|bananrepubliker
bananskal|bananskal
banbrytare|banbrytare
band|band
bandage|bandage
bändelkorsnäbb|bändelkorsnäbbar
banderoll|banderoller
baneman|banemän
bånge|bångar
bängel|bänglar
bangladeshiska|bangladeshiskor
bank|bankar
bänk|bänkar
bankdosa|bankdosor
bankoktroj|bankoktrojer
banna|bannor
bantning|bantningar
bar|barer
bär|bär
barbar|barbarer
barberare|barberare
bard|barder
bård|bårder
bärhäggmispel|bärhäggmisplar
bark|barkar
barm|barmar
barn|barn
barnbacke|barnbackar
barnbarn|barnbarn
barnbidrag|barnbidrag
barnbokklubb|barnbokklubbar
barncykel|barncyklar
barndom|barndomar
barnfamilj|barnfamiljer
barnfilm|barnfilmer
barnflicka|barnflickor
barnhem|barnhem
barnläkare|barnläkare
barnleksak|barnleksaker
barnmorska|barnmorskor
barnprogram|barnprogram
barnsäng|barnsängar
barnsjukdom|barnsjukdomar
barnsko|barnskor
barnvagn|barnvagnar
barnvakt|barnvakter
barnvåldtäkt|barnvåldtäkter
barometer|barometrar
baron|baroner
bärplockare|bärplockare
barr|barr
barréklämma|barréklämmor
barrskog|barrskogar
barrträd|barrträd
bärs|bärs
bärvåg|bärvågor
bärvårtkaktus|bärvårtkaktusar
baryon|baryoner
baryton|barytoner
bas|basar
bås|bås
basfall|basfall
basfiol|basfioler
basilika|basilikor
basist|basister
basker|baskrar
basketboll|basketbollar
baskiska|baskiskor
bassäng|bassänger
bastard|bastarder
bästis|bästisar
bastu|bastur
bastubad|bastubad
basvektor|basvektorer
båt|båtar
båtshake|båtshakar
batteri|2
batteriladdare|batteriladdare
bäver|bävrar
beagle|beaglar
bearbetning|bearbetningar
bebis|bebisar
bebyggelse|bebyggelser
bedömare|bedömare
bedömning|bedömningar
bedrift|bedrifter
befallning|befallningar
befattning|befattningar
befolkning|befolkningar
befordran|befordringar
befruktning|befruktningar
begär|begär
begåvning|begåvningar
begeistring|begeistringar
begränsning|begränsningar
begränsningsarea|begränsningsareor
begravning|begravningar
begravningsannons|begravningsannonser
begravningsentreprenör|begravningsentreprenörer
begrepp|begrepp
begynnelsevillkor|begynnelsevillkor
behå|behåar
behag|behag
behållare|behållare
behandling|behandlingar
behov|behov
bekännelse|bekännelser
bekymmer|bekymmer
belackare|belackar
belägg|belägg
beläte|beläten
belgare|belgare
belgiska|belgiskor
belopp|belopp
bemärkelse|bemärkelser
bemötande|bemötanden
ben|ben
bena|benor
benämning|benämningar
benhinna|benhinnor
bensin|bensiner
bensinkrig|bensinkrig
beräkning|beräkningar
berättelse|berättelser
beredande|beredanden
berg|berg
berg- och dalbana|berg- och dalbanor
berg-och-dal-bana|berg-och-dal-banor
berg-och-dalbana|berg-och-dalbanor
bergand|bergänder
bergandshane|bergandshanar
bergandshona|bergandshonor
bergart|bergarter
bergatroll|bergatroll
bergfink|bergfinkar
bergfinkshane|bergfinkshanar
bergfinkshona|bergfinkshonor
berghäggmispel|berghäggmisplar
bergis|bergisar
bergkaktus|bergkaktusar
berglärka|berglärkor
bergmästare|bergmästare
bergochdalbana|bergochdalbanor
bergodalbana|bergodalbanor
bergsfiskal|bergsfiskaler
bergsfogde|bergsfogdar
bergskam|bergskammar
bergspass|bergspass
berguv|berguvar
berguvshane|berguvshanar
berguvshona|berguvshonor
beridare|beridare
beroende|beroenden
beröring|beröringar
berusning|berusningar
besättning|besättningar
besittning|besittningar
besked|besked
beskickning|beskickningar
beskrifning|beskrifningar
beslut|beslut
beslutande|beslutanden
besök|besök
besökare|besökare
bess|bess
besserwisser|besserwissrar
best|bestar
beställare|beställare
beställning|beställningar
beståndsdel|beståndsdelar
bestick|bestick
bestyr|bestyr
besvär|besvär
besvikelse|besvikelser
bet|betar
beta|beta
betäckning|betäckningar
betalare|betalare
betalning|betalningar
betapartikel|betapartiklar
betaversion|betaversioner
bete|betar
beteckning|beteckningar
beteende|beteenden
betjänt|betjänter
betonggris|betonggrisar
betongsugga|betongsuggor
betraktande|betraktande
betraktare|betraktare
bets|betser
bett|bett
betydelse|betydelser
betyg|betyg
betygsättning|betygsättningar
beundrare|beundrare
bevakningslista|bevakningslistor
bevarandelag|bevarandelagar
bevis|bevis
bh|bh:ar
bi|2
biätare|biätare
biätarfjäder|biätarfjädrar
biathlon|biathlons
bibba|bibbor
bibbla|bibblor
bibel|biblar
bibliofil|bibliofiler
biblioman|bibliomaner
bibliotaf|bibliotafer
bibliotek|bibliotek
bibliotekarie|bibliotekarier
bidrag|bidrag
bidragsgivare|bidragsgivare
bieffekt|bieffekter
bienn|bienner
bifall|bifall
biff|biffar
biflod|bifloder
bigata|bigator
bigotteri|bigotterier
bihang|bihang
bijektion|bijektioner
bikaka|bikakor
bikille|bikillar
bil|bilar
bila|bilor
biläger|biläger
bilbomb|bilbomber
bild|bilder
bilderbok|bilderböcker
bildläsare|bildläsare
bildpunkt|bildpunkter
bildrulle|bildrullar
bildskärm|bildskärmar
bildspel|bildspel
bildtext|bildtexter
bilförare|bilförare
bilindustri|bilindustrier
bilist|bilister
biljard|biljarder
biljardbord|biljardbord
biljett|biljetter
billion|billioner
bilmotor|bilmotorer
bilväg|bilvägar
bindeord|bindeord
bindestreck|bindestreck
bindning|bindningar
binge|bingar
binom|binom
binomialkoefficient|binomialkoefficienter
binomialutveckling|binomialutvecklingar
bio|biografer
biobesök|biobesök
biobesökare|biobesökare
biobiljett|biobiljetter
bioduk|biodukar
biofilm|biofilmer
biograf|biografer
biografi|biografier
biografmaskinist|biografmaskinister
biografpianist|biografpianister
biolog|biologer
biosalong|biosalonger
bira|biror
birfilare|birfilare
bisektris|bisektriser
biskop|biskopar
bismak|bismaker
bit|bitar
bitjej|bitjejer
bitsår|bitsår
bivax|bivaxer
bivråk|bivråkar
bivråkshane|bivråkshanar
bivråkshona|bivråkshonor
bjässe|bjässar
björk|björkar
björkna|björknor
björkskog|björkskogar
björktrast|björktrastar
björktrasthane|björktrasthanar
björktrasthona|björktrasthonor
björn|björnar
björnbär|björnbär
björnbärskompott|björnbärskompotter
björnbärskräm|björnbärskrämer
björnbärsmarmelad|björnbärsmarmelader
björnbärspaj|björnbärspajer
björnbärssylt|björnbärssyltar
björntjänst|björntjänster
bjugg|bjugg
blåbär|blåbär
blåbärskaktus|blåbärskaktusar
blåbärskompott|blåbärskompotter
blåbärskräm|blåbärskrämer
blåbärspaj|blåbärspajer
blåbärssaft|blåbärssafter
blåbärssoppa|blåbärssoppor
blåbärssylt|blåbärssylter
black|blackar
bläckhorn|bläckhorn
bläckpenna|bläckpennor
blad|blad
blaffa|blaffor
blåhake|blåhakar
blåklint|blåklintar
blåklocka|blåklockor
blåkopia|blåkopior
blåkråka|blåkråkor
blåmärke|blåmärken
blåmes|blåmesar
blåmeshane|blåmeshanar
blåmeshona|blåmeshonor
blandband|blandband
blandning|blandningar
blandras|blandraser
blandsaft|blandsafter
blandskog|blandskogar
blankett|blanketter
blanksteg|blanksteg
blåsa|blåsor
bläsand|bläsänder
bläsandshane|bläsandshanar
bläsandshona|bläsandshonor
bläsgås|bläsgäss
blåsik|blåsikar
blåsinstrument|blåsinstrument
blåsippa|blåsippor
blaska|blaskor
blåskata|blåskator
blåsnonett|blåsnonetter
blåstjärt|blåstjärtar
blåstrumpa|blåstrumpor
blåtrast|blåtrastar
blatte|blattar
bleckblåsinstrument|bleckblåsinstrument
bleka|blekor
blick|blickar
blida|blidor
blixt|blixtar
blixtlås|blixtlås
block|block
blockflöjt|blockflöjter
blodapelsin|blodapelsiner
bloddroppe|bloddroppar
blodfruktspelarkaktus|blodfruktspelarkaktusar
blodgrupp|blodgrupper
blodigel|blodiglar
blodkärl|blodkärl
blodkropp|blodkroppar
blodpudding|blodpuddingar
blodsdroppe|blodsdroppar
blogg|bloggar
bloggare|bloggare
blöja|blöjor
blöjbarn|blöjbarn
blomkålssallad|blomkålssallader
blomkålssoppa|blomkålssoppor
blomkruka|blomkrukor
blomkvistare|blomkvistare
blomma|blommor
blomstermånad|blomstermånader
blondin|blondiner
bloss|bloss
blötta|blöttor
blottare|blottare
Blu-ray-skiva|Blu-ray-skivor
blues|blueslåtar
bluesskala|bluesskalor
blunder|blundrar
blyertspenna|blyertspennor
blygis|blygisar
bo|bon
boa|boor
bock|bockar
bockhornskaktus|bockhornskaktusar
böckling|böcklingar
bod|bodar
boende|boende
boendekostnad|boendekostnader
boffertomte|boffertomtar
bofink|bofinkar
bog|bogar
bög|bögar
böghög|böghögar
bohag|bohag
bohem|bohemer
böj|böjar
boja|bojor
böjelse|böjelser
böjning|böjningar
böjningsform|böjningsformer
böjningstabell|böjningstabeller
bok|böcker
bokföring|bokföringar
bokhylla|bokhyllor
bokklubb|bokklubbar
boklåda|boklådor
bokmal|bokmalar
bokmärke|bokmärken
bokningssystem|bokningssystem
bokserie|bokserier
bokskog|bokskogar
bokslukare|bokslukare
bokslut|bokslut
bokstav|bokstäver
bokstöd|bokstöd
boktitel|boktitlar
bokuppslag|bokuppslag
bokverk|bokverk
bolag|bolag
bolåker|bolåkrar
bolivian|bolivianer
bolivianska|bolivianskor
bölja|böljor
boll|bollar
bollkalle|bollkallar
bollspel|bollspel
bollsport|bollsporter
bolster|bolster
bomb|bomber
bombflyg|bombflyg
bombhot|bombhot
bombplan|bombplan
bomullsvårtkaktus|bomullsvårtkaktusar
bön|böner
böna|bönor
bondbränna|bondbrännor
bonde|bönder
bondeförvandling|bondeförvandlingar
bondgård|bondgårdar
bondläpp|bondläppar
bondlurk|bondlurkar
bondpermis|bondpermisar
bondpermission|bondpermissioner
bong|bongar
böngrodd|böngroddar
bonnbränna|bonnbrännor
bonnlurk|bonnlurkar
bonnpermis|bonnpermisar
bönsoppa|bönsoppor
bonus|bonusar
bord|bord
börda|bördor
bordell|bordeller
bordläggning|bordläggningar
bordsbön|bordsböner
borg|borgar
borgarbracka|borgarbrackor
borgare|borgare
borgarråd|borgarråd
borgenär|borgenärer
borgensman|borgensmän
början|början
börjare|börjare
borr|borrar
borrhål|borrhål
borrsväng|borrsvängar
börs|börser
borste|borstar
borstpelarkaktus|borstpelarkaktusar
bortre parentes|bortre parenteser
borttagning|borttagningar
boské|boskéer
bosnier|bosnier
bosniska|bosniskor
boson|bosoner
boss|bossar
bössa|sparbössor
bostadsbidrag|bostadsbidrag
bot|böter
botaniker|botaniker
bott|bottar
botten|bottnar
bottenkvark|bottenkvarkar
bov|bovar
bövel|bövlar
bowlinghall|bowlinghallar
bowlingklot|bowlingklot
bowlingsko|bowlingskor
box|boxar
boxare|boxare
boxer|boxrar
boxermotor|boxermotorer
boxervalp|boxervalpar
brackvatten|brackvatten
bräda|brädor
brädd|bräddar
bragd|bragder
bråk|bråk
brakförlust|brakförluster
bråkmakare|bråkmakare
bråkstake|bråkstakar
bråkstreck|bråkstreck
bralla|brallor
brallis|brallisar
brand|bränder
brandbil|brandbilar
brandkår|brandkårerer
brandman|brandmän
brandrisk|brandrisker
brandstege|brandstegar
brandvägg|brandväggar
brandvarnare|brandvarnare
branle|branler
bränna|brännor
brännsår|brännsår
brännvinsglas|brännvinsglas
bransch|branscher
bränsle|bränslen
bräsch|bräscher
brasilianare|brasilianare
brasilianska|brasilianskor
brasilkaktus|brasilkaktusar
brasklapp|brasklappar
brasse|brassar
brassestol|brassestolar
brat|brats
bratwurst|bratwurstar
braxen|braxnar
bred pendelkaktus|bred pendelkaktusar
bredd|bredder
bref|bref
brev|brev
brevbärare|brevbärare
brevduva|brevduvor
brevinkast|brevinkast
brevlåda|brevlådor
brevlådeklubb|brevlådeklubbar
brevporto|brevporton
brevvän|brevvänner
bridge|bridges
brikett|briketter
bringa|bringor
brist|brister
britt|britter
brittiska|brittiskor
bro|broar
broccolisoppa|broccolisoppor
bröd|bröd
brödbekymmer|brödbekymmer
brödbit|brödbitar
broder|bröder
broderi|broderier
broderskap|broderskap
brödkavel|brödkavlar
brodös|brodöser
brödrost|brödrostar
brödskiva|brödskivor
brokkaktus|brokkaktusar
brokpelarkaktus|brokpelarkaktusar
brolla|brollor
bröllop|bröllop
broms|bromsar
brons|brons
bronsdjävulstunga|bronsdjävulstungor
bronsibis|bronsibisar
bronskaktus|bronskaktusar
bronsmedalj|bronsmedaljer
bror|bröder
brorsa|brorsor
brorsdotter|brorsdöttrar
brorson|brorsöner
brosch|broscher
bröst|bröst
bröstbarn|bröstbarn
brott|brott
brottsling|brottslingar
brottsplats|brottsplatser
browser|browsrar
brud|brudar
brudgum|brudgummar
brudpar|brudpar
brugd|brugder
bruk|bruk
bruksanvisning|bruksanvisningar
bruksort|bruksorter
brun pysslingkaktus|brun pysslingkaktusar
brunand|brunänder
brunandshane|brunandshanar
brunandshona|brunandshonor
brunch|bruncher
brunett|brunetter
brunn|brunnar
brunnslock|brunnslock
brunråtta|brunråttor
brushane|brushanar
brutta|bruttor
brygga|bryggor
bryggeri|bryggerier
brylling|bryllingar
bryn|bryn
brytning|brytningar
brytningsindex|brytningsindex
bubbla|bubblor
bud|bud
budget|budgeter
budgetunderskott|budgetunderskott
budgivning|budgivningar
budord|budord
budskap|budskap
bugg|buggar
bugning|bugningar
buk|bukar
bukett|buketter
bukspottkörtel|bukspottkörtlar
buksvåger|buksvågrar
buksvägerska|buksvägerskor
buksyster|buksystrar
bulgar|bulgarer
bulgariska|bulgariskor
buljongtärning|buljongtärningar
bulle|bullar
bult|bultar
bumling|bumlingar
bunke|bunkar
bunsenbrännare|bunsenbrännare
bunt|buntar
buntband|buntband
buntrem|buntremmar
bur|burar
burk|burkar
burka|burkor
burmes|burmeser
burmesiska|burmesiskor
burundier|burundier
bus|bus
buskage|buskage
buske|buskar
buskis|buskisar
buskkaktus|buskkaktusar
busksångare|busksångare
buskskvätta|buskskvättor
buss|bussar
bussbälte|bussbälten
bussbiljett|bussbiljetter
bussbolag|bussbolag
busschaufför|busschaufförer
bussdepå|bussdepåer
bussförare|bussförare
bussgata|bussgator
busshållplats|busshållplatser
busskörkort|busskörkort
busskort|busskort
busskur|busskurer
busslast|busslaster
busslinje|busslinjer
bussresa|bussresor
busstid|busstider
busstidtabell|busstidtabeller
busstoalett|busstoaletter
butelj|buteljer
butik|butiker
butternutpumpa|butternutpumpor
by|byar
byfåne|byfånar
bygge|byggen
byggherre|byggherrar
byggnad|byggnader
byk|bykar
bykmaskin|bykmaskiner
byrå|byråar
byracka|byrackor
byrålåda|byrolådor
byst|byster
byte|byten
byxa|byxor
cacheminne|cacheminne
caddie|caddies
café|caféer
call|callar
camping|campingar
capo|capon
capodastro|capodastron
capotasto|capotaston
CD-skiva|CD-skivor
cedilj|cediljer
cell|celler
cellist|cellister
cembalo|cembalor
censor|censorer
center|centrar
centiliter|centiliter
centimeter|centimeter
centralbank|centralbanker
centraltagg|centraltaggar
centripetalacceleration|centripetalaccelerationer
centripetalkraft|centripetalkrafter
cerat|cerat
ceremoni|ceremonier
champagneglas|champagneglas
champinjon|champinjoner
champinjonsoppa|champinjonsoppor
chans|chanser
charmkvark|charmkvarkar
charmonium|charmoniums
charterbuss|charterbussar
chaufför|chaufförer
check|checkar
cheddar|cheddars
chef|chefer
chefredaktör|chefredaktörer
cherokes|cherokeser
cherokesiska|cherokesiskor
chilenare|chilenare
chilenska|chilenskor
chili|chilifrukter
chips|chips
chock|chocker
choke|chokar
choklad|choklader
chokladboll|chokladbollar
chokladkaka|chokladkakor
chokladpålägg|chokladpålägg
chokladpannkaka|chokladpannkakor
chokladsås|chokladsåser
Christmånad|Christmånader
cigarett|cigaretter
cigarr|cigarrer
cigarrett|cigarretter
cigg|cigg
cineast|cineaster
cirkel|cirklar
cirkelbåge|cirkelbågar
cirkeldefinition|cirkeldefinitioner
cirkulationsintegral|cirkulationsintegraler
cirkulationsplats|cirkulationsplatser
cirkumfix|cirkumfix
cirkus|cirkusar
cirkusdirektör|cirkusdirektörer
citadell|citadeller
citat|citat
citatlån|citatlån
citering|citat
citron|citroner
citronärla|citronärlor
citronfjäril|citronfjärilar
citronmarmelad|citronmarmelader
citronsaft|citronsafter
citronsjöborrekaktus|citronsjöborrekaktusar
citronsorbet|citronsorbeter
citrusfrukt|citrusfrukter
cittra|cittror
civilingenjör|civilingenjörer
civilmilitär|civilmilitärer
clo-värde|clo-värden
Clo-värde|Clo-värden
CLO-värde|CLO-värden
coach|coacher
cockpit|cockpitar
cognacsglas|cognacsglas
colombian|colombianer
colombianska|colombianskor
container|containrar
cookie|cookies
corps de logi|corps de logier
country|countries
cp|cp:n
cp-nerv|cp-nerver
CPU|CPU:er
crack|crack
crackhora|crackhoror
credit|credits
CRT-skärm|CRT-skärmar
cup|cuper
cykel|cyklar
cykelbana|cykelbanor
cykeldäck|cykeldäck
cykelhjälm|cykelhjälmar
cykelhjul|cykelhjul
cykelkorg|cykelkorgar
cykellås|cykellås
cykellopp|cykellopp
cykelnyckel|cykelnycklar
cykelpedal|cykelpedaler
cykelsadel|cykelsadlar
cykelsemester|cykelsemestrar
cykelslang|cykelslangar
cykelställ|cykelställ
cykelstöld|cykelstölder
cykelstyre|cykelstyren
cykeltjuv|cykeltjuvar
cykeltrampa|cykeltrampor
cykelväg|cykelvägar
cyklist|cyklister
cyklon|cykloner
cylinder|cylindrar
cylinderkranskaktus|cylinderkranskaktusar
cylindervårtkaktus|cylindervårtkaktusar
cymbal|cymbaler
cymbalist|cymbalister
cyniker|cyniker
cypress|cypresser
cypriot|cyprioter
D-körkort|D-körkort
da|dar
däck|däck
dåd|dåd
dadel|dadlar
dadelkompott|dadelkompotter
dagboksnyckel|dagboksnycklar
dager|dagrar
däggdjur|däggdjur
daggmelonkaktus|daggmelonkaktusar
daggpelarkaktus|daggpelarkaktusar
daggvårtkaktus|daggvårtkaktusar
daghem|daghem
dagis|dagis
dagisfröken|dagisfröknar
daglega|daglegor
daglönare|daglönare
dagstidning|dagstidningar
dajm|dajm
dajmkryss|dajmkryss
dal|dalar
dalahäst|dalahästar
däld|dälder
dalmatiner|dalmatiner
dalmatinerhund|dalmatinerhundar
dalmatinervalp|dalmatinervalpar
dalripa|dalripor
dalskida|dalskidor
dalslänning|dalslänningar
dam|damer
damcykel|damcyklar
damm|dammar
dammsnäppa|dammsnäppor
dammsugare|dammsugare
dammsugning|dammsugningar
dammvippa|dammvippor
damtävling|damtävlingar
damtoalett|damtoaletter
dån|dån
dank|dankar
dans|danser
dansare|dansare
dansband|dansband
dansgolv|dansgolv
danska|danskor
danslärare|danslärare
danssko|dansskor
dåre|dårar
dårskap|dårskaper
dase|dasar
dass|dass
data|datorer
databas|databaser
databashanterare|databashanterare
datafil|datafiler
datamaskin|datamaskiner
datavirus|datavirus
dativ|dativer
dator|datorer
datorfil|datorfiler
datormus|datormöss
datorprogram|datorprogram
datorskärm|datorskärmar
datorspel|datorspel
datorvirus|datorvirus
datum|datum
deadline|deadlines
debacle|debacle
debatt|debatter
debut|debuter
debutant|debutanter
debutroman|debutromaner
deceleration|decelerationer
december|decembermånader
decennium|decennier
decibel|decibel
deciliter|deciliter
decimalkomma|decimalkomman
decimalpunkt|decimalpunkter
deckare|deckare
definition|definitioner
definitionsmängd|definitionsmängder
definitionsområde|definitionsområden
deflation|deflationer
deg|degar
degspade|degspadar
deism|deismer
deist|deister
dekadens|dekadenser
dekagon|dekagoner
dekalogi|dekalogier
deklination|deklinationer
dekolletage|dekolletage
dekoltage|dekoltage
dekoration|dekorationer
dekret|dekret
dekryptering|dekrypteringar
del|delar
delägare|delägare
delare|delare
delegation|delegationer
delfin|delfiner
delgrupp|delgrupper
delikatessbutik|delikatessbutiker
delirium|deliria
delmängd|delmängder
delstat|delstater
delta|deltan
deltagare|deltagare
deltagarportal|deltagarportaler
deltid|deltider
demagog|demagoger
demant|demanter
dementi|dementier
demiurg|demiurger
demografi|demografier
demokrati|demokratier
demonstrant|demonstranter
demonstration|demonstrationer
demoralisering|demoraliseringar
demotejp|demotejper
dendrofil|dendrofiler
densitet|densiteter
departement|departement
deponens|deponentier
deponensverb|deponensverb
deponent|deponenter
depression|depressioner
derivat|derivat
derivata|derivator
design|designer
designer|designer
destruent|destruenter
detalj|detaljer
detektiv|detektiver
detektivroman|detektivromaner
detektor|detektorer
determinant|determinanter
detronisation|detronisationer
detronisering|detroniseringar
diabetiker|diabetiker
diagonalmatris|diagonalmatriser
diagram|diagram
diakon|diakoner
dialekt|dialekter
dialog|dialoger
diamant|diamanter
diameter|diametrar
diapaus|diapauser
diarré|diarréer
diaspora|diasporor
dien|diener
diesel|dieslar
diet|dieter
differens|differenser
differensekvation|differensekvationer
differenskvot|differenskvoter
differentialekvation|differentialekvationer
digestivekex|digestivekex
digitalkamera|digitalkameror
dike|diken
dikt|dikter
diktator|diktatorer
diktatur|diktaturer
dildo|dildoar
dilettant|dilettanter
dill|dillar
dillande|dillanden
dilleri|dillerier
dimension|dimensioner
diminutiv|diminutiver
dimljus|dimljus
dimma|dimmor
diod|dioder
dipeptid|dipeptider
diplom|diplom
diplomat|diplomater
dipol|dipoler
direktion|direktioner
direktiv|direktiv
direktör|direktörer
direktsändning|direktsändningar
dirigent|dirigenter
disackarid|disackarider
disciplin|discipliner
disco|discon
disk|diskar
diskbänk|diskbänkar
diskborste|diskborstar
diskett|disketter
diskmaskin|diskmaskiner
diskmedel|diskmedel
diskning|diskningar
diskontinuitet|diskontinuiteter
diskrepans|diskrepanser
diskriminant|diskriminanter
disktrasa|disktrasaor
diskurs|diskurser
diskurspartikel|diskurspartiklar
diskussion|diskussioner
diskussionsdeltagare|diskussionsdeltagare
diskussionssida|diskussionssidor
diskvalificering|diskvalificeringar
dispens|dispenser
dispersion|dispersioner
dispersionsrelation|dispersionsrelationer
display|displayer
disposition|dispositioner
disputation|disputationer
dispyt|dispyter
dissonans|dissonanser
distans|distanser
distinktion|distinktioner
distributör|distributörer
distrikt|distrikt
diva|divor
divalat|divalater
divalater|divalater
divan|divaner
divergens|divergenser
divis|diviser
division|divisioner
divisor|divisorer
djävul|djävlar
djävulsrocka|djävulsrockor
djiboutier|djiboutier
djiboutiska|djiboutiskor
djungel|djungler
djupledsboll|djupledsbollar
djupledspassning|djupledspassningar
djur|djur
djurart|djurarter
DM|DM
doa|door
doakör|doakörer
döbattang|döbattanger
döbelnsmedicin|döbelnsmediciner
docent|docenter
docka|dockor
dockskåp|dockskåp
dodekaeder|dodekaedrar
dodekaflexagon|dodekaflexagoner
dödsbo|dödsbon
dödskalle|dödskallar
dödslista|dödslistor
dödsorsak|dödsorsaker
dödsstöt|dödsstötar
dödsstraff|dödsstraff
doft|dofter
doftämne|doftämnen
dojo|dojor
doktor|doktorer
doktorand|doktorander
dokument|dokument
dokumentation|dokumentationer
dokusåpa|dokusåpor
dokusåpadeltagare|dokusåpadeltagare
doldis|doldisar
dolk|dolkar
domän|domäner
domare|domare
domherre|domherrar
domsaga|domsagor
domstol|domstolar
don|don
donare|donare
donaulax|donaulaxar
dönicke|dönickar
donna|donnor
dop|dop
dopp|dopp
dopparda|doppardar
doppardag|doppardagar
doppareda|dopparedar
dopparedag|dopparedagar
dopping|doppingar
dörr|dörrar
dörrmatta|dörrmattor
dörrnyckel|dörrnycklar
dos|doser
dös|dös
dosimeter|dosimetrar
döskalle|döskallar
doter|dotrar
dotter|döttrar
dotterbolag|dotterbolag
dotterdotter|dotterdöttrar
dotterson|dottersöner
dotterspråk|dotterspråk
drag|drag
dragbasun|dragbasuner
dragon|dragoner
dragspel|dragspel
dragspelare|dragspelare
dragster|dragstrar
dragtvång|dragtvång
drake|drakar
dräkt|dräkter
dram|dramer
dramaturg|dramaturger
dräng|drängar
dråp|dråp
draw|draws
drev|drev
dribblare|dribblare
dricka|drickor
driftkucku|driftkuckuar
drifva|drifvor
drillsnäppa|drillsnäppor
drink|drinkar
drinkare|drinkare
driva|drivor
driver|drivers
drivhus|drivhus
drivrutin|drivrutiner
drog|droger
drogmissbrukare|drogmissbrukare
dröjsmål|dröjsmål
dröm|drömmar
dromedar|dromedarer
droppe|droppar
drös|drösar
drossel|drosslar
drottning|drottningar
drottningkaktus|drottningkaktusar
drottningsylt|drottningsylter
drufva|drufvor
dryck|drycker
dryckestermos|dryckestermosar
dualis|dualis
dualism|dualismer
dubbelbeckasin|dubbelbeckasiner
dubbelbindning|dubbelbindningar
dubbelbonde|dubbelbönder
dubbeldäckare|dubbeldäckare
dubbelfnutt|dubbelfnuttar
dubbelintegral|dubbelintegraler
dubbelkors|dubbelkors
dubbelmacka|dubbelmackor
dubbelprimtecken|dubbelprimtecken
dubbelschack|dubbelschackar
dubbelstjärna|dubbelstjärnor
dubbeltrast|dubbeltrastar
dubblett|dubbletter
duell|dueller
dufva|dufvor
dugga|duggor
duggregn|duggregn
duk|dukar
dukat|dukater
dumbom|dumbommar
dumburk|dumburkar
dumhet|dumheter
dumhuvud|dumhuvuden
dump|dumpar
dumskalle|dumskallar
dumstrut|dumstrutar
dunge|dungar
dunkel|dunkel
duo|duor
duplikat|duplikat
durkslag|durkslag
durskala|durskalor
durtonart|durtonarter
dusch|duschar
dussin|dussin
duva|duvor
duvhök|duvhökar
duvhökshane|duvhökshanar
duvhökshona|duvhökshonor
duvslag|duvslag
dvala|dvalor
dvärg|dvärgar
dvärgbeckasin|dvärgbeckasiner
dvärgkaktus|dvärgkaktusar
dvärglärka|dvärglärkor
dvärgmås|dvärgmåsar
dvärgmaskros|dvärgmaskrosor
dvärgörn|dvärgörnar
dvärgplanet|dvärgplaneter
dvärgrördrom|dvärgrördromar
dvärgskarv|dvärgskarvar
dvärgsparv|dvärgsparvar
dvärgsumphöna|dvärgsumphönor
dvärguv|dvärguvar
DVD|DVD
DVD-brännare|DVD-brännare
DVD-film|DVD-filmer
DVD-skiva|DVD-skivor
DVD-spelare|DVD-spelare
dyad|dyader
dyckert|dyckertar
dygd|dygder
dygn|dygn
dykare|dykare
dykcert|dykcert
dynamitard|dynamitarder
dynamometer|dynamometrar
dynasti|dynastier
dysfori|dysforier
e-brev|e-brev
e-meddelande|e-meddelanden
e-postadress|e-postadresser
e-postbrev|e-postbrev
e-postkonto|e-postkonton
e-postmeddelande|e-postmeddelanden
eagle|eagles
ecuadorian|ecuadorianer
ecuadorianska|ecuadorianskor
editering|editeringar
effekt|effekter
effektivitet|effektiviteter
efterfest|efterfester
eftergiftstaktik|eftergiftstaktiker
efterled|efterled
eftermäle|eftermälen
eftermiddag|eftermiddagar
eftermiddagsrast|eftermiddagsraster
efternamn|efternamn
efterrätt|efterrätter
efterskalv|efterskalv
eg|ege
egendom|egendomar
egenfunktion|egenfunktioner
egennamn|egennamn
egenrum|egenrum
egenskap|egenskaper
egenvärde|egenvärden
egenvektor|egenvektorer
egg|eggar
egoist|egoister
egyptier|egyptier
egyptiska|egyptiskor
ejakulation|ejakulationer
ejder|ejdrar
ejderhane|ejderhanar
ejderhona|ejderhanar
ek|ekar
eka|ekor
ekare|ekare
eko|ekon
ekolod|ekolod
ekolog|ekologer
ekonomi|ekonomier
ekorre|ekorrar
ekosystem|ekosystem
ekskog|ekskogar
ekvation|ekvationer
ekvationssystem|ekvationssystem
ekvator|ekvatorer
ekvatorsplan|ekvatorsplan
ekvivalens|ekvivalenser
ekvivalenspil|ekvivalenspilar
ekvivokation|ekvivokationer
elakhet|elakheter
elaking|elakingar
elavbrott|elavbrott
elbas|elbasar
eld|eldar
elddop|elddop
eldningsförbud|eldningsförbud
eldsjäl|eldsjälar
eldsvåda|eldsvådor
eldvapen|eldvapen
elefant|elefanter
elegi|elegier
elektor|elektorer
elektriker|elektriker
elektron|elektroner
elektronisk komponent|elektroniska komponenter
elektronrör|elektronrör
element|element
elementarläroverk|elementarläroverk
elementarpartikel|elementarpartikar
eleonorafalk|eleonorafalkar
elev|elever
elevator|elevatorer
elevmatsal|elevmatsalar
elf|elfvar
elftedel|elftedelar
elg|elger
elgitarr|elgitarrer
elitidrott|elitidrotter
elitserie|elitserier
eller|eller
ellips|ellipser
ellipsoid|ellipsoider
eloge|eloger
elongation|elongationer
elorgel|elorglar
elverk|elverk
EM|EM
EM-brons|EM-brons
EM-final|EM-finaler
EM-guld|EM-guld
EM-medalj|EM-medaljer
EM-silver|EM-silver
emaljöga|emaljögon
embargo|embargon
embarkeringskort|embarkeringskort
emfas|emfaser
Emilia|Emilie
emissionslinje|emissionslinjer
emissionsnebulosa|emissionsnebulosor
emittans|emittanser
emo|emon
empativolym|empativolymer
en passant|en passanter
enbär|enbär
enbuske|enbuskar
encyklopedi|encyklopedier
endomorfi|endomorfier
endomorfism|endomorfismer
engagemang|engagemang
engångsbesökare|engångsbesökare
engelska|engelskor
engelsklärare|engelsklärare
engelsman|engelsmän
engifte|engiften
engländare|engländare
enhet|enheter
enhetscirkel|enhetscirklar
enhetsintervall|enhetsintervall
enhetsmatris|enhetsmatriser
enhetsnormal|enhetsnormaler
enhetsvektor|enhetsvektorer
enhjuling|enhjulingar
enhörning|enhörningar
enka|enkor
enkät|enkäter
enkelbeckasin|enkelbeckasiner
enkelbiljett|enkelbiljetter
enkelbindning|enkelbindningar
enkelintegral|enkelintegraler
enkrona|enkronor
ennealogi|ennealogier
ensamrätt|ensamrätter
ensamvarg|ensamvargar
ensemble|ensembler
enskog|enskogar
ental|ental
entita|entitor
entré|entréer
entreprenad|entreprenader
entreprenör|entreprenörer
entropi|entropier
entusiast|entusiaster
enzym|enzym
epatraktor|epatraktorer
epifyt|epifyter
epileptiker|epileptiker
epistel|epistlar
epitafium|epitafier
epitel|epitel
epok|epoker
eponym|eponymer
era|eror
erbjudande|erbjudanden
eremitskogstrast|eremitskogstrastar
erfarenhet|erfarenheter
erinran|erinran
errata|errator
erratum|errata
ersättare|ersättare
ersättningsbuss|ersättningsbussar
eruption|eruptioner
erytrocyt|erytrocyter
eskort|eskorter
eskortflicka|eskortflickor
eskortpojke|eskortpojkar
eskulap|eskulaper
ess|ess
essä|essäer
est|ester
ester|estrar
estländska|estländskor
estlänning|estlänningar
estniska|estniskor
et-tecken|et-tecken
etablissemang|etablissemang
eter|etrar
etikettering|etiketteringar
etiopier|etiopier
etiopiska|etiopiskor
etnofobi|etnofobier
etta|ettor
ettagluttare|ettagluttare
etyd|etyder
etymologi|etymologier
EU-moped|EU-mopeder
EU-moppe|EU-moppar
eufemism|eufemismer
eufori|euforier
euro|euro
euroland|euroländer
europamästerskap|europamästerskap
Europamästerskap|Europamästerskap
europé|européer
evakuering|evakueringar
evangelium|evangelier
evenemang|evenemang
eventualitet|eventualiteter
evighet|evigheter
evighetsmaskin|evighetsmaskiner
evolution|evolutioner
ex|ex
examen|examina
examensbeskrivning|examensbeskrivningar
examensbevis|examensbevis
exempel|exempel
exemplar|exemplar
existens|existenser
exkrement|exkrementer
exoplanet|exoplaneter
exorcist|exorcister
experiment|experiment
expert|experter
explosion|explosioner
exponent|exponenter
exponentialfunktion|exponentialfunktioner
exponeringstid|exponeringstider
export|exporter
extern|externer
extrapris|extrapriser
extrempunkt|extrempunkter
extremvärde|extremvärden
fä|fän
fabel|fabler
fabrik|fabriker
fabriksarbetare|fabriksarbetare
facit|facit
fack|fack
fackförbund|fackförbund
fackla|facklor
fackord|fackord
fadäs|fadäser
fadder|faddrar
fader|fäder
fädernesland|fädernesland
fåfänga|fåfängor
fågel|fåglar
fågelägg|fågelägg
fågelart|fågelarter
fågelbo|fågelbon
fågelfamilj|fågelfamiljer
fågelfrö|fågelfrön
fågelhund|fågelhundar
fågelskådare|fågelskådare
fågelskrämma|fågelskrämmor
fagott|fagotter
fagottist|fagottister
fähund|fähundar
fajt|fajter
fåk|fåkar
faksimil|faksimiler
faktabok|faktaböcker
faktaruta|faktarutor
faktor|faktorer
faktorisering|faktoriseringar
faktura|fakturor
fakultet|fakulteter
falafel|falaflar
falang|falanger
fåle|fålar
falk|falkar
Falköpingare|Falköpingare
fall|fall
fålla|fållor
fälla|fällor
fälleben|fälleben
fallenhet|fallenheter
fallos|fallosar
fallskärm|fallskärmar
fallskärmshoppare|fallskärmshoppare
fällstol|fällstolar
fallucka|falluckor
fält|fält
faltkajak|faltkajakar
fältpiplärka|fältpiplärkor
fältsparv|fältsparvar
falukorv|falukorvar
familj|familjer
famn|famnar
famntag|famntag
fan|fans
fån|fån
fanatiker|fanatiker
fåne|fånar
faner|faner
fanerogam|fanerogamer
fånge|fångar
fängelse|fängelser
fängslande|fängslanden
fanskap|fanskap
fantasi|fantasier
fantasipris|fantasipriser
fantasy|fantasies
fåntratt|fåntrattar
far|fäder
får|får
fara|faror
fåra|fåror
fåraherde|fåraherdar
farao|faraoner
farbroder|farbröder
farbror|farbröder
färd|färder
färdighet|färdigheter
farfar|farfäder
farförälder|farföräldrar
färg|färger
färgburk|färgburkar
färgladdning|färgladdningar
färing|färingar
färja|färjor
farlighet|farligheter
farmor|farmödrar
färöing|färöingar
färöiska|färösiskor
fårost|fårostar
farsa|farsor
färskpotatis|färskpotatisar
farsot|farsoter
farstu|farstur
fart|farter
fartyg|fartyg
farväl|farväl
fasa|fasor
fasan|fasaner
fascist|fascister
fasta|fastor
fäste|fästen
faster|fastrar
fastighet|fastigheter
fastighetsägare|fastighetsägare
fastighetsskatt|fastighetsskatter
fastlagsbulle|fastlagsbullar
fästman|fästmän
fästmö|fästmör
fat|fat
fatabur|fataburar
fåtal|fåtal
fatbur|fatburar
fåtölj|fåtöljer
fattiglapp|fattiglappar
fattning|fattningar
faute|fauter
favorit|favoriter
fax|faxar
fe|feer
febertermometer|febertermometrar
februari|februarimånader
feedback|feedback
fegis|fegisar
feja|fejor
fejs|fejs
fel|fel
fela|felor
felaktighet|felaktigheter
felfortplantning|felfortplantningar
felslut|felslut
felstavning|felstavningar
femhörning|femhörningar
femhundrakronorssedel|femhundrakronorssedlar
femidom|femidomer
femininum|femininer
femkrona|femkronor
femma|femmor
femminutare|femminutare
femminutersutvisning|femminutersutvisningar
femtal|femtal
femtedel|femtedelar
femtiokronorssedel|femtiokronorssedlar
femtioöring|femtioöringar
femtondedel|femtondedelar
femtondel|femtondelar
femtonhundrameterslopp|femtonhundrameterslopp
fenix|fenixar
fenomen|fenomen
fenomenologi|fenomenologier
fenotyp|fenotyper
Fermattal|Fermattal
ferment|ferment
fermion|fermioner
fest|fester
festival|festivaler
festivalgäst|festivalgäster
festivalstämning|festivalstämningar
festlighet|festligheter
festprisse|festprissar
fetischist|fetischister
fett|fetter
fettsyra|fettsyror
fettvävnad|fettvävnader
fez|fezer
fiasko|fiaskon
fiberpenna|fiberpennor
ficka|fickor
fickdator|fickdatorer
ficklampa|ficklampor
fickplunta|fickpluntor
ficktjuv|ficktjuvar
fickur|fickur
fiende|fiender
figur|figurer
fijian|fijianer
fijianska|fijanskor
fik|fik
fika|fikor
fikapaus|fikapauser
fikarast|fikaraster
fikonkaktus|fikonkaktusar
fikonmarmelad|fikonmarmelader
fiktion|fiktioner
fil|filer
filantrop|filantroper
filatelist|filatelister
fildelare|fildelare
filé|filéer
filformat|filformat
filial|filialer
filibuster|filibustrar
film|filmer
filmatisering|filmatiseringar
filmografi|filmografier
filmtitel|filmtitlar
filnamn|filnamn
filolog|filologer
filosof|filosofer
filt|filtar
filter|filter
filtillägg|filtillägg
filur|filurer
fimbulvinter|fimbulvintrar
fimp|fimpar
final|finaler
finansminister|finansministrar
finger|fingrar
fingerborg|fingerborgar
fingernagel|fingernaglar
fingervårtkaktus|fingervårtkaktusar
finka|finkor
finkläder|finkläder
finländare|finländare
finlandsfärja|finlandsfärjor
finländska|finländskor
finlandsresa|finlandsresor
finlandssvenska|finlandssvenskor
finne|finnar
finska|finskor
finsko|finskor
fint|finter
fiol|fioler
firma|firmaor
firre|firrar
fis|fisar
fisk|fiskar
fiskägg|fiskägg
fiskare|fiskare
fiskart|fiskarter
fiske|fisken
fiskebåt|fiskebåtar
fiskfilé|fiskfiléer
fiskgjuse|fiskgjusar
fisklever|fisklevrar
fiskleverolja|fiskleveroljor
fiskmacka|fiskmackor
fiskmås|fiskmåsar
fisksmörgås|fisksmörgåsar
fisksoppa|fisksoppor
fisktärna|fisktärnor
fission|fissioner
fitta|fittor
fittamad|fittamadar
fittemad|fittemadar
fix|fixar
fixare|fixare
fixpunkt|fixpunkter
fjäder|fjädrar
fjäderboll|fjäderbollar
fjäderkonstant|fjäderkonstanter
fjädervårtkaktus|fjädervårtkaktusar
fjäll|fjäll
fjälla|fjällor
fjällabb|fjällabbar
fjällbjörkskog|fjällbjörkskogar
fjällgås|fjällgäss
fjällmaskros|fjällmaskrosor
fjällpipare|fjällpipare
fjällrapa|fjällrapar
fjällripa|fjällripor
fjälluggla|fjällugglor
fjällvråk|fjällvråkar
fjant|fjantar
fjärdedel|fjärdedelar
fjäril|fjärilar
fjärilshund|fjärilshundar
fjärilsim|fjärilsim
fjärr|fjärrar
fjärrkontroll|fjärrkontroller
fjärrtåg|fjärrtåg
fjät|fjät
fjätter|fjättrar
fjolår|fjolår
fjolla|fjollor
fjord|fjordar
fjortis|fjortisar
fjortondedel|fjortondedelar
fjortondel|fjortondelar
fläck|fläckar
fläckborttagningsmedel|fläckborttagningsmedel
fläckdrillsnäppa|fläckdrillsnäppor
fläckmaskros|fläckmaskrosor
fläckpolska|fläckpolskor
fladdermus|fladdermöss
fläder|flädrar
fläderbär|fläderbär
fläderblomma|fläderblommor
flädersaft|flädersafter
flagga|flaggor
flaggstång|flaggstänger
flakong|flakonger
fläkt|fläktar
flamländare|flamländare
flamländska|flamländskor
flank|flanker
flaska|flaskor
flaskbarn|flaskbarn
fläskberg|fläskberg
fläskfilé|fläskfiléer
flaskhals|flaskhalsar
fläskkorv|fläskkorvar
fläskläpp|fläskläppar
flaskpost|flaskposter
flåsning|flåsningar
flata|flator
fläta|flätor
flax|flaxs
flertal|flertal
flexagon|flexagoner
flicka|flickor
flicknamn|flicknamn
flickvän|flickvänner
flik|flikar
flin|flin
flinga|flingor
flintis|flintisar
flipperspel|flipperspel
flock|flockar
flod|floder
flöde|flöden
flödesintegral|flödesintegraler
flödesschema|flödesscheman
flodmynning|flodmynningar
flodsångare|flodsångare
flodvåg|flodvågor
flodvågskatastrof|flodvågskatastrofer
flöjt|flöjter
flöjtfodral|flöjtfodral
flor|flor
flora|floror
floskel|floskler
flöte|flöten
flotte|flottar
fluga|flugor
flugsnappare|flugsnappare
flum|flum
flundra|flundror
flunsa|flunsor
fluorid|fluorider
fly|flyn
flyg|flyg
flygbiljett|flygbiljetter
flygbuss|flygbussar
flygel|flyglar
flygelhorn|flygelhorn
flygfoto|flygfoton
flygplan|flygplan
flygplansvinge|flygplansvingar
flygplats|flygplatser
flykt|flykter
flykthastighet|flykthastigheter
flykting|flyktingar
flytetyg|flytetyg
flytt|flyttar
flyttfågel|flyttfåglar
flytväst|flytvästar
fnask|fnask
fobi|fobier
fock|fockar
föda|födor
födelse|födelser
födelsedag|födelsedagar
födelsedagsbarn|födelsedagsbarn
födelsedagsfest|födelsedagsfester
födelsedagskalas|födelsedagskalas
foder|fodren
födsel|födslar
fog|fogar
fogel|foglar
fokus|fokus
föl|föl
fölbox|fölboxar
fold|foldar
folder|foldrar
folie|folier
följd|följder
följdsats|följdsatser
folk|folk
folka|folkor
folkkyrka|folkkyrkor
folkmassa|folkmassor
folkomröstning|folkomröstningar
folkskola|folkskolor
folkvagn|folkvagnar
fön|fönar
fond|fonder
fonofobi|fonofobier
fonon|fononer
fönster|fönster
fönsterbleck|fönsterbleck
fönsterputsare|fönsterputsare
fönsterputsning|fönsterputsningar
foppatoffel|foppatofflor
fora|foror
förälder|föräldrar
förälskelse|förälskelser
förändring|förändringar
förare|förare
förarhytt|förarhytter
förbehåll|förbehåll
förberedelse|förberedelseer
förbifartsled|förbifartsleder
förbindelse|förbindelser
förbränning|förbränningar
förbud|förbud
förbund|förbund
förbundskapten|förbundskaptener
förbundsland|förbundsländer
fördel|fördelar
fördom|fördomar
fordon|fordon
fordran|fordringar
fordring|fordringar
fordringsägare|fordringsägare
förebild|förebilder
föredrag|föredrag
förekomst|förekomster
forell|foreller
föremål|föremål
förening|föreningar
föreställning|föreställningar
företag|företag
företagare|företagare
företeelse|företeelser
företrädare|företrädare
förfall|förfall
förfallodatum|förfallodatum
författare|författare
författarinna|författarinnor
förfest|förfester
förflyttning|förflyttningar
förföljare|förföljare
förfrysning|förfrysningar
förgätmigej|förgätmigejer
förgiftning|förgiftningar
förgrening|förgreningar
förhållande|förhållanden
förhandling|förhandlingar
förhäst|förhästar
förhör|förhör
förhud|förhudar
förklaring|förklaringar
förkortning|förkortningar
förkylning|förkylningar
förlag|förlag
förled|förled
förlust|förluster
form|former
förmåga|förmågor
förman|förmän
förmån|förmåner
format|format
formatkrig|formatkrig
formatmall|formatmallar
formel|formler
formelblad|formelblad
formgivare|formgivare
förmiddag|förmiddagar
förmiddagsrast|förmiddagsraster
förmodan|förmodanden
förmögenhet|förmögenheter
förnamn|förnamn
förnimmelse|förnimmelser
förnuftighet|förnuftigheter
förort|förorter
förortshak|förortshak
förövare|förövare
förpackning|förpackningar
förråd|förråd
förrädare|förrädare
förrätt|förrätter
fors|forsar
försäkringsbolag|försäkringsbolag
försäkringsfall|försäkringsfall
försäkringsgivare|försäkringsgivare
försäljning|försäljningar
församling|församlingar
forsärla|forsärlor
förseelse|förseelser
försele|förselar
försening|förseningar
forskare|forskare
förskingring|förskingringar
forskningsfält|forskningsfält
förskola|förskolor
förskolebarn|förskolebarn
förslag|förslag
försök|försök
försöksdjur|försöksdjur
försökskanin|försökskaniner
försprång|försprång
förstaderivata|förstaderivator
förståelse|förståelser
förstånd|förstånd
förstföderska|förstföderskor
förstörelse|förstörelser
förstoring|förstoringar
förstoringsglas|förstoringsglas
fort|fort
förtecken|förtecken
förteckning|förteckningar
förtjänst|förtjänster
fortkörare|fortkörare
förtroende|förtroenden
förutsättning|förutsättningar
förvaltning|förvaltningar
förvaltningsområde|förvaltningsområden
förvaring|förvaringar
förvaringsutrymme|förvaringsutrymmen
förvarning|förvarningar
fosfat|fosfater
fossing|fossingar
foster|foster
fot|fötter
fotabjälle|fotabjälle
fotboll|fotbollar
fotbollslandslag|fotbollslandslag
fotbollsplan|fotbollsplaner
fotbollsspelare|fotbollsspelare
fotgängare|fotgängare
fotled|fotleder
fotnot|fotnoter
foto|foton
fotoautotrof|fotoautotrofer
fotograf|fotografer
fotografi|fotografier
foton|fotoner
fotosfär|fotosfärer
fotostatkopia|fotostatkopior
fotspår|fotspår
fotsteg|fotsteg
foul|foul
foulard|foularder
Fourierserie|Fourierserier
fräckis|fräckisar
fråga|frågor
frågetecken|frågetecken
fragment|fragment
fräkne|fräknar
fraktion|fraktioner
fraktionalisering|fraktionaliseringar
fralla|frallor
frälsare|frälsare
framförande|framföranden
främling|främlingar
främmande|främmanden
framtid|framtider
framträdande|framträdanden
frände|fränder
frankrikeresa|frankrikeresor
frånsida|frånsidor
franska|franskor
fransklärare|fransklärare
fransman|fransmän
fransos|fransoser
fransyska|fransyskor
fras|fraser
frätskada|frätskador
freak|freak
fred|freder
fredag|fredagar
fredagkväll|fredagkvällar
fredagmorgon|fredagmorgnar
fredagskväll|fredagskvällar
fredagsmorgon|fredagsmorgnar
fredsavtal|fredsavtal
frekvens|frekvenser
frekvensutrymme|frekvensutrymmen
friare|friare
fribonde|fribönder
fridlysning|fridlysningar
friggebod|friggebodar
frihet|friheter
friidrottare|friidrottare
frikativa|frikativor
friktionskoefficient|friktionskoefficienter
frikyrka|frikyrkor
frilansjournalist|frilansjournalister
frilla|frillor
friluftsdag|friluftsdagar
frimärke|frimärken
frimärkssamlare|frimärkssamlare
frimurare|frimurare
fripassagerare|fripassagerare
frisiska|frisiskor
friskola|friskolor
frisör|frisörer
frissa|frissor
frist|frister
frisyr|frisyrer
fritid|fritider
fritids|fritids
fritidspolitiker|fritidspolitiker
fritis|fritis
fritös|fritöser
frizon|frizoner
frö|frön
fröjd|fröjder
fröken|fröknar
frökenfisk|frökenfiskar
front|fronter
frontalkrock|frontalkrockar
frossa|frossor
fru|fruar
fruga|frugor
frukost|frukostar
frukt|frukter
fruktkräm|fruktkrämer
fruktsaft|fruktsafter
fruktsallad|fruktsallader
fruktträd|fruktträd
fruktträdgård|fruktträdgårdar
fruntimmer|fruntimmer
frygier|frygier
frys|frysar
frysfack|frysfack
fryspunkt|fryspunkter
frysvara|frysvaror
fubbick|fubbickar
fulhack|fulhack
fundament|fundament
fundamentalist|fundamentalister
funderande|funderanden
fundering|funderingar
funk|funks
funktion|funktioner
funktional|funktionaler
funktionalekvation|funktionalekvationer
funktionär|funktionärer
funktionsrum|funktionsrum
funktor|funktorer
fur|furs
fura|furor
furste|furstar
fusion|fusioner
fusk|fusk
fuskare|fuskare
fusklapp|fusklappar
futhark|futharker
fylla|fyllor
fyllecell|fylleceller
fylleslag|fylleslag
fyllesvin|fyllesvin
fyra|fyror
fyrhjuling|fyrhjulingar
fyrhörning|fyrhörningar
fyrkant|fyrkanter
fyrtal|fyrtal
fys|fys
fysiker|fysiker
fyspass|fyspass
gädda|gäddor
gäddhäng|gäddhäng
gaffel|gafflar
gåfva|gåfvor
gage|gager
gäl|gälar
gala|galor
galax|galaxer
gäld|gälder
galge|galgar
galghumor|galghumorer
gäliska|gäliskor
gall|galler
galler|galler
galleri|gallerier
gällivarehäng|gällivarehäng
galning|galningar
galopp|galopper
galt|galtar
gam|gamar
gamäng|gamänger
gamba|gambor
gambier|gambier
gambiska|gambiskor
gambit|gambitar
gamma|gamma
gammelfarbror|gammelfarbröder
gammelgranskog|gammelgranskogar
gång|gångar
gäng|gäng
gångare|gångare
gångart|gångarter
gångled|gångleder
ganglion|ganglier
gangster|gangstrar
gångväg|gångvägar
gap|gap
gaphals|gaphalsar
gapskratt|gapskratt
garage|garage
garanti|garantier
gard|garder
gård|gårdar
garderob|garderober
gärdesgård|gärdesgårdar
gardin|gardiner
gardinstång|gardinstänger
gärdsmyg|gärdsmygar
gärning|gärningar
gärningsort|gärningsorter
garrottering|garrotteringar
gärs|gärsar
garv|garv
garvare|garvare
garveri|garverier
gas|gaser
gås|gäss
gåsfjäder|gåsfjädrar
gåsgam|gåsgamar
gåshud|gåshudar
gasjätte|gasjättar
gåskarl|gåskarlar
gäspning|gäspningar
gässling|gässlingar
gasspis|gasspisar
gast|gastar
gäst|gäster
gästbok|gästböcker
gata|gator
gåta|gåtor
gate|gater
gatt|gatt
gatukorsning|gatukorsningar
gaullist|gaullister
gåva|gåvor
gavial|gavialer
gazi|gazier
geggamoja|geggamojor
geggveck|geggveck
gehäng|gehäng
gelé|geléer
geléhallon|geléhallon
gem|gem
gemål|gemåler
gemenskap|gemenskaper
gen|gener
general|generaler
generalöverste|generalöverstar
generalsekreterare|generalsekreterare
generation|generationer
generatris|generatriser
genitiv|genitiver
genkarta|genkartor
genom|genom
genombrott|genombrott
genomskärare|genomskärare
genomsnitt|genomsnitt
genotyp|genotyper
genre|genrer
genrep|genrep
genus|genus
genväg|genvägar
geodet|geodeter
geofyt|geofyter
geolog|geologer
georgier|georgier
georgiska|georgiskor
gerilla|gerillor
gesäll|gesäller
gesant|gesanter
geschäft|geschäft
gest|gester
gestalt|gestalter
get|getter
geting|getingar
getost|getostar
gevär|gevär
gif|gifvar
giffel|gifflar
gift|gifter
gifte|giften
giftermål|giftermål
giftkaktus|giftkaktusar
gigolo|gigolor
gille|gillen
gillestuga|gillestugor
gimmick|gimmickar
ginikoefficient|ginikoefficienter
gir|girar
giraff|giraffer
girering|gireringar
girigbuk|girigbukar
gisslan|gisslan
gissning|gissningar
gitarr|gitarrer
gitarrist|gitarrister
gitarrvirtuos|gitarrvirtuoser
gitter|gitter
giv|givar
gjord|gjordar
gjutform|gjutformer
glaciär|glaciärer
glada|glador
glädjehus|glädjehus
glänta|gläntor
glappkontakt|glappkontakter
glas|glas
glasburk|glasburkar
glashus|glashus
glasöga|glasögon
glasögon|glasögon
glasögonflugsnappare|glasögonflugsnappare
glasögonorm|glasögonormar
glass|glassar
glassbar|glassbarer
glassbil|glassbilar
glasskärare|glasskärare
glasspinne|glasspinnar
glasstrut|glasstrutar
glastermos|glastermosar
glasvårtkaktus|glasvårtkaktusar
glasyr|glasyrer
glidare|glidare
glimmer|glimmer
glob|glober
glödlampa|glödlampor
glosa|glosor
gluon|gluoner
glutt|gluttar
gluttsnäppa|gluttsnäppor
glytt|glyttar
gnagare|gnagare
gnällmåns|gnällmånsar
gnällspik|gnällspikar
gnet|gnetter
gnist|gnistar
gnu|gnuer
gnukalv|gnukalvar
gnuunge|gnuungar
goare|goare
goddagspilt|goddagspiltar
godis|godisar
godisbutik|godisbutiker
godisgris|godisgrisar
godkännande|godkännanden
godnattkram|godnattkramar
godnattpuss|godnattpussar
godnattsaga|godnattsagor
godsak|godsaker
gödsel|gödslar
gödsling|gödslingar
göjemånad|göjemånader
gök|gökar
göktyta|göktytor
göktyteholk|göktyteholkar
golare|golare
golf|golfer
golfarkitekt|golfarkitekter
golfbag|golfbagar
golfboll|golfbollar
golfklubba|golfklubbor
golv|golv
golvlist|golvlister
golvur|golvur
gom|gommar
gömma|gömmor
google|googlar
googlesökning|googlesökningar
googleträff|googleträffar
googling|googlingar
göra|görer
görare|görare
gördel|gördlar
gorilla|gorillor
göromål|göromål
gös|gösar
gospel|gospels
gosse|gossar
gossebarn|gossebarn
gössoppa|gössoppor
göt|göt
götamål|götamål
göteborgare|göteborgare
göteborgska|göteborgskor
gourmand|gourmander
gourmé|gourméer
gourmet|gourmeter
grabb|grabbar
grad|grader
gräddbulle|gräddbullar
gräddkola|gräddkolor
gräddsnipa|gräddsnipor
gradient|gradienter
graf|grafer
grafikkort|grafikkort
grafräknare|grafräknare
grafritare|grafritare
grågam|grågamar
grågås|grågäss
gråhäger|gråhägrar
gråhakedopping|gråhakedoppingar
gräl|gräl
grålira|gråliror
gram|gram
grammatik|grammatiker
grammatika|grammatikor
grammatiker|grammatiker
grammofon|grammofoner
grammofonskiva|grammofonskivor
gran|granar
granat|granater
granit|graniter
granne|grannar
gräns|gränser
gransångare|gransångare
gränsdragning|gränsdragningar
granskning|granskningar
granskog|granskogar
gränspolis|gränspoliser
gränsvärde|gränsvärden
grapefrukt|grapefrukter
gräs|gräs
gräsand|gräsänder
gräsandshane|gräsandshanar
gräsandshona|gräsandshonor
gräsänka|gräsänkor
gräsänkling|gräsänklingar
gräsfläck|gräsfläckar
gräshoppsångare|gräshoppsångare
gråsiska|gråsiskor
gräsklippare|gräsklippare
gräsmånad|gräsmånader
gräsmatta|gräsmattor
gråsosse|gråsossar
gråsparv|gråsparvar
gråspett|gråspettar
gräsplätt|gräsplätter
gråsuggekaktus|gråsuggekaktusar
gratäng|gratänger
gråtrut|gråtrutar
grav|gravar
gravand|gravänder
gravandshane|gravandshanar
gravandshona|gravandshonor
graviditet|graviditeter
gravitationskraft|gravitationskrafter
graviton|gravitoner
grävling|grävlingar
grävmaskin|grävmaskiner
green|greener
grej|grejer
greja|grejor
grejsimojs|grejsimojser
grek|greker
grekinna|grekinnor
grekiska|grekiskor
gren|grenar
grenadjär|grenadjärer
grenadör|grenadörer
grenbana|grenbanor
grenvårtkaktus|grenvårtkaktusar
grep|grepar
grepp|grepp
greve|grevar
grill|grillar
grimma|grimmor
grin|grin
grind|grindar
grip|gripar
gris|grisar
grobian|grobianer
groda|grodor
grodägg|grodägg
groddjur|groddjur
grodyngel|grodyngel
grogg|groggar
grönbena|grönbenor
grönfink|grönfinkar
gröngöling|gröngölingar
grönländare|grönländare
grönländska|grönländskor
grönlänning|grönlänningar
grönsak|grönsaker
grönsakssoppa|grönsakssoppor
grönsiska|grönsiskor
gröt|grötar
grotta|grottor
groupie|groupies
grund|grund
grundämne|grundämnen
grundare|grundare
grundform|grundformer
grundlag|grundlagar
grundmängd|grundmängder
grundsmak|grundsmaker
grunka|grunkor
grupp|grupper
gruppledare|gruppledare
gruppvåldtäkt|gruppvåldtäkter
grusväg|grusvägar
gruva|gruvor
gruvarbetare|gruvarbetare
grymhet|grymheter
gryn|gryn
gryning|gryningar
grynvälling|grynvällingar
gryt|gryt
gryta|grytor
gubbe|gubbar
gubbhuvudkaktus|gubbhuvudkaktusar
gubbstrutt|gubbstruttar
gubbvälde|gubbvälden
gud|gudar
gudasaga|gudasagor
gudinna|gudinnor
gudom|gudomar
guide|guider
gula|gulor
gulärla|gulärlor
guld|guld
guldfisk|guldfiskar
guldhalt|guldhalter
guldhamster|guldhamstrar
guldkaktus|guldkaktusar
guldmedalj|guldmedaljer
guldmynt|guldmynt
guldpeng|guldpengar
guldsjöborrekaktus|guldsjöborrekaktusar
guldtrast|guldtrastar
gulhämpling|gulhämplingar
gullsydkaktus|gullsydkaktusar
gullviva|gullvivor
gulsparv|gulsparvar
gulsporre|gulsporrar
gumma|gummor
gummi|gummin
gummistövel|gummistövlar
gunga|gungor
gunghäst|gunghästar
gunst|gunster
gura|guror
gurka|gurkor
gurkmeja|gurkmejor
gurksoppa|gurksoppor
guss|gussar
guzz|guzzar
gyllensparv|gyllensparvar
gylta|gyltor
gymnasieskola|gymnasieskolor
gymnasist|gymnasister
gymnasium|gymnasier
gymnast|gymnaster
gymnastiksal|gymnastiksalar
gynofobi|gynofobier
gyrosrulle|gyrosrullar
gyttja|gyttjor
habrovink|habrovinker
habrovinsch|habrovinscher
häck|häckar
hacka|hackor
hackare|hackare
hackkyckling|hackkycklingar
häcklöpare|häcklöpare
hackordning|hackordningar
häcksparv|häcksparvar
hadron|hadroner
haf|haf
häfte|häften
hage|hagar
hagel|hagel
häger|hägrar
hägg|häggar
häggmispel|häggmisplar
häggskog|häggskogar
haitier|haitier
haj|hajar
hak|hak
haka|hakor
håkäring|håkäringar
hake|hakar
haklapp|haklappar
haksydkaktus|haksydkaktusar
häktning|häktningar
hakvårtkaktus|hakvårtkaktusar
hål|hål
häl|hälar
håla|hålor
hälare|hälare
hälft|hälftar
hålighet|håligheter
hälkappa|hälkappor
hall|hallar
hallåa|hallåor
halländska|halländskor
hallgolv|hallgolv
hallick|hallickar
hallklot|hallklot
hållning|hållningar
hallon|hallon
hallongelé|hallongeléer
hallonkompott|hallonkompotter
hallonkräm|hallonkrämer
hallonmarmelad|hallonmarmelader
hallonsaft|hallonsafter
hallonsorbet|hallonsorbeter
hallonsylt|hallonsylter
hållplats|hållplatser
halmstacksvårtkaktus|halmstacksvårtkaktusar
halofyt|halofyter
halogenid|halogenider
hals|halsar
halsband|halsband
halsbandsflugsnappare|halsbandsflugsnappare
halsduk|halsdukar
hälsning|hälsningar
hälsoresa|hälsoresor
halva|halvor
halvår|halvår
halvbroder|halvbröder
halvbror|halvbröder
halvcirkel|halvcirklar
halvcirkelbåge|halvcirkelbågar
halvdag|halvdagar
halvdager|halvdagrar
halvfabrikat|halvfabrikat
halvledare|halvledare
halvlek|halvlekar
halvliter|halvlitrar
halvö|halvöar
halvsyskon|halvsyskon
halvsyster|halvsystrar
halvtimma|halvtimmar
halvtimme|halvtimmar
halvton|halvtoner
halvtrappa|halvtrappor
hamburgare|hamburgare
hamburgerkedja|hamburgerkedjor
hamburgerrestaurang|hamburgerrestauranger
hamn|hamnar
hämndbegär|hämndbegär
hämning|hämningar
hamnstad|hamnstäder
hämpling|hämplingar
hämsko|hämskor
hån|hån
hand|händer
handarbete|handarbeten
handboll|handbollar
handdator|handdatorer
handduk|handdukar
handelsbolag|handelsbolag
händelse|händelser
händelsehorisont|händelsehorisonter
handfat|handfat
handflata|handlflator
handgemäng|handgemäng
handikapp|handikapp
handklaver|handklaver
handled|handleder
handledare|handledare
handling|handlingar
handrygg|handryggar
hands|hands
handsättare|handsättare
handske|handskar
hane|hanar
hangarfartyg|hangarfartyg
hängmatta|hängmattor
hängning|hängningar
hanhund|hanhundar
hankatt|hankatter
hantverkare|hantverkare
hår|hår
här|härar
härad|härader
häradshövding|häradshövdingar
häradsrätt|häradsrätter
harang|haranger
härbärge|härbärgen
hårborste|hårborstar
hårddisk|hårddiskar
hårdrockare|hårdrockare
hårdskiva|hårdkivor
hårdvara|hårdvaror
hare|harar
härfågel|härfåglar
hårfärg|hårfärger
härförare|härförare
härjelse|härjelser
härjning|härjningar
härk|härkar
hårklyveri|hårklyverier
harkrank|harkrankar
härledning|härledningar
harm|harms
härmapa|härmapor
harmoni|harmonier
härmsångare|härmsångare
härnad|härnader
hårnål|hårnålar
hårnålskurva|hårnålskurvor
harpa|harpor
harpalt|harpaltar
harpist|harpister
harpun|harpuner
harr|harrar
härskare|härskare
härskarteknik|härskartekniker
harvärja|harvärjor
has|hasor
håsa|håsor
hasselbackspotatis|hasselbackspotatisar
hasselmus|hasselmöss
hasselnöt|hasselnötter
hasselskog|hasselskogar
hässja|hässjor
häst|hästar
hästfordon|hästfordon
hastighet|hastigheter
hastighetsbegränsning|hastighetsbegränsningar
hastighetsförändring|hastighetsförändringar
hastighetsmätare|hastighetsmätare
hästkraft|hästkrafter
hästsvans|hästsvansar
hat|hats
hatt|hattar
hättkvarn|hättkvarnar
hausse|hausser
hav|hav
havregrynsgröt|havregrynsgrötar
havremoped|havremopeder
havsörn|havsörnar
havssula|havssulor
hävstång|hävstänger
havstrut|havstrutar
havsvåg|havsvågor
häxa|häxor
häxring|häxringar
hed|hedar
hedonist|hedonister
hedpiplärka|hedpiplärkor
hegemoni|hegemonier
hegge|heggen
hejare|hejare
hejduk|hejdukar
hektar|hektar
hektoliter|hektoliter
hela|helor
helg|helger
helgedom|helgedomar
helgmålsringning|helgmålsringningar
helgon|helgon
helhet|helheter
helikopter|helikoptrar
helikopterperspektiv|helikopterperspektiv
helsike|helsiken
heltal|heltal
helton|heltoner
heltonsskala|heltonsskalor
helvete|helveten
hem|hem
hematofobi|hematofobier
hembiträde|hembiträden
hemisfär|hemisfärer
hemland|hemländer
hemlighet|hemligheter
hemlighetsmakeri|hemlighetsmakerier
hemlis|hemlisar
hemsida|hemsidor
hemstad|hemstäder
hemställan|hemställningar
heptaflexagon|heptaflexagoner
heptagon|heptagoner
heptalogi|heptalogier
herbarium|herbarier
herbivor|herbivorer
hermafrodit|hermafroditer
herptil|herptiler
herr|herar
herrcykel|herrcyklar
herre|herrar
herrtävling|herrtävlingar
herrtoalett|herrtoaletter
hertig|hertigar
hertiginna|hertiginnor
Hertzsprung–Russell-diagram|Hertzsprung–Russell-diagram
hessian|hessianer
hetero|heteron
hexadecimal|hexadecimaler
hexaeder|hexaedrar
hexaflexagon|hexaflexagoner
hexagon|hexagoner
hexalogi|hexalogier
hidalgo|hidalgor
hierarki|hierarkier
hieroglyf|hieroglyfer
hillebard|hillebarder
himlakropp|himlakroppar
himmel|1
himmelssfär|himmelssfärer
hinder|hinder
hingst|hingstar
hink|hinkar
hinna|hinnor
hispa|hispor
hiss|hissar
histogram|histogram
historia|historier
historiker|historiker
hjälm|hjälmar
hjälpfil|hjälpfiler
hjälte|hjältar
hjältinna|hjältinnor
hjärna|hjärnor
hjärnsläpp|hjärnsläpp
hjärta|hjärtan
hjärter|hjärter
hjässa|hjässor
hjerta|hjertan
hjon|hjon
hjonelag|hjonelag
hjord|hjordar
hjortron|hjortron
hjortronkompott|hjortronkompotter
hjortronkräm|hjortronkrämer
hjortronsorbet|hjortronsorbeter
hjortronsylt|hjortronsylter
hjul|hjul
ho|hoar
hobby|hobbyer
hockeyfrilla|hockeyfrillor
hodda|hoddor
höftsjuka|höftsjukor
hög|högar
högaffel|högafflar
högerled|högerled
höghus|höghus
högkvarter|högkvarter
högljud|högljud
högskola|högskolor
högtalare|högtalare
hoj|hojar
höjd|höjder
höjdhoppare|höjdhoppare
höjdhopperska|höjdhopperskor
höjdpunkt|höjdpunkter
höjning|höjningar
hök|hökar
hökrok|hökrokar
hökuggla|hökugglor
hölje|höljen
holländare|holländare
holländska|holländskor
holme|holmar
holmgång|holmgångar
holonym|holonymer
hömånad|hömånader
homeomorfi|homeomorfier
homo|homon
homoadoption|homoadoptioner
homoäktenskap|homoäktenskap
homofob|homofober
homofobi|homofobier
homofon|homofoner
homograf|homografer
homolog kromosom|homologa kromosomer
homomorfi|homomorfier
homomorfism|homomorfismer
homonym|homonymer
homosexualitet|homosexualiteter
homovigsel|homovigslar
hona|honor
höna|hönor
honeypot|honeypots
höns|höns
hönsägg|hönsägg
hönshjärna|hönshjärnor
hönskornell|hönskorneller
honungsvårtkaktus|honungsvårtkaktusar
hop|hopar
hoplofobi|hoplofobier
hopp|hopp
hopprep|hopprep
hopptorn|hopptorn
hora|horor
horisont|horisonter
horisontalkvarn|horisontalkvarnar
hörlur|hörlurar
horn|horn
hörn|hörn
hornmaskros|hornmaskrosor
hornuggla|hornugglor
hörsal|hörsalar
horunge|horungar
hospital|hospital
hossa|hossor
höst|höstar
höstack|höstackar
höstkantarell|höstkantareller
höstlov|höstlov
höstlöv|höstlöv
höstmånad|höstmånader
höstvårtkaktus|höstvårtkaktusar
hot|hot
hotell|hotell
hötjuga|hötjugor
hov|hovar
hövding|hövdingar
hovmarskalk|hovmarskalkar
hovtång|hovtänger
HR-diagram|HR-diagram
hud|hudar
hudsalva|hudsalvor
hudsonspov|hudsonspovar
hue|huen
hufvud|hufvuden
hug|hugs
hugg|hugg
huggmejsel|huggmejslar
huggorm|huggormar
huggvapen|huggvapen
hulling|hullingar
hult|hult
humla|humlor
hummer|humrar
hummersoppa|hummersoppor
humör|humör
hund|hundar
hundare|hundaren
hunddjur|hunddjur
hundhedning|hundhedningar
hundhuvud|hundhuvuden
hundmatskål|hundmatskålar
hundracka|hundrackor
hundradel|hundradelar
hundrakronorssedel|hundrakronorssedlar
hundralapp|hundralappar
hundras|hundraser
hundratal|hundratal
hundring|hundringar
hundskall|hundskall
hundstall|hundstall
hunduppfödare|hunduppfödare
hundvalp|hundvalpar
hurring|hurringar
hus|hus
husband|husband
husdjur|husdjur
husdörr|husdörrar
husesyn|husesyner
husgeråd|husgeråd
hushåll|hushåll
hushållsassistent|hushållsassistenter
husmus|husmöss
husse|hussar
hussvala|hussvalor
hustru|hustrur
huv|huvar
huva|huvor
huve|huven
huvtröja|huvtröjor
huvud|huvuden
huvudbonad|huvudbonader
huvuddiagonal|huvuddiagonaler
huvudkontor|huvudkontor
huvudkudde|huvudkuddar
huvudkvadrat|huvudkvadrater
huvudlus|huvudlöss
huvudman|huvudmän
huvudord|huvudord
huvudroll|huvudroller
huvudsak|huvudsaker
huvudsida|huvudsidor
huvudstad|huvudstäder
huvudväderstreck|huvudväderstreck
hvalf|hvalf
hvarf|hvarf
hvila|hvilor
hvita|hvitor
hybble|hybblen
hybrid|hybrider
hycklare|hycklare
hydda|hyddor
hyena|hyenor
hylla|hyllor
hylsa|hylsor
hynda|hyndor
hyperbel|hyperbler
hyperlänk|hyperlänkar
hyperonym|hyperonymer
hypokondriker|hypokondriker
hyponym|hyponymer
hypotenusa|hypotenusor
hypotes|hypoteser
hyra|hyror
hyresgäst|hyresgäster
hyreshus|hyreshus
hyresrätt|hyresrätter
hyresvärd|hyresvärdar
hyska|hyskor
hyss|hyss
hyttippump|hyttippumpar
iakttagare|iakttagare
ichthyolog|ichthyologer
icke-metall|icke-metaller
id|idar
ide|iden
idé|idéer
ideal|ideal
identitetsmatris|identitetsmatriser
ideolog|ideologer
ideologi|ideologier
idéspruta|idésprutor
idiom|idiom
idiot|idioter
idiotmatt|idiotmattar
ido|idoj
idrott|idrotter
idyll|idyller
igel|iglar
igelkott|igelkottar
igelkottskaktus|igelkottskaktusar
ikon|ikoner
ikonografi|ikonografier
ikosaeder|ikosaedrar
iktyolog|iktyologer
il|Ackusativ
iller|illrar
illusion|illusioner
illustration|illustrationer
ilning|ilningar
ilska|ilskor
imam|imamer
imma|immor
immigrant|immigranter
immunförsvar|immunförsvar
impedans|impedanser
imperativform|imperativformer
imperfektform|imperfektformer
imperialism|imperialismer
implikation|implikationer
implikationspil|implikationspilar
implosion|implosioner
import|importer
impuls|impulser
impulsköp|impulsköp
inälva|inälvor
inbilska|inbilskor
inbjudare|inbjudare
inbördeskrig|inbördeskrig
inbromsning|inbromsningar
inbrott|inbrott
incident|incidenter
incitament|incitament
index|index
indian|indianer
indier|indier
indikator|indikatorer
indiska|indiskor
individ|individer
indonesier|indonesier
indonesiska|indonesiskor
indragning|indragningar
induktans|induktanser
industri|industrier
infanteri|infanterier
inferno|infernon
infix|infix
inflation|inflationer
inflektionspunkt|inflektionspunkter
inflexionspunkt|inflexionspunkter
införande|införanden
informant|informanter
information|informations
inforuta|inforutor
infusion|infusioner
ingefära|ingefäror
ingefärsmarmelad|ingefärsmarmelader
ingrediens|ingredienser
ingress|ingresser
inhibition|inhibitioner
injektion|injektioner
inkarnation|inkarnationer
inkomst|inkomster
inkubationstid|inkubationstider
inkubator|inkubatorer
inkvisitor|inkvisitorer
inlägg|inlägg
innebandyboll|innebandybollar
innebandyspelare|innebandyspelare
innehållsförteckning|innehållsförteckningar
innehav|innehav
inneröra|inneröron
innerslang|innerslangar
innevånare|innevånare
inomhustävling|inomhustävlingar
inomhusvärldsmästare|inomhusvärldsmästare
inredning|inredningar
insättande|insättanden
insättning|insättningar
insegel|insegel
insekt|insekter
insektsätare|insektsätare
insexnyckel|insexnycklar
insinuation|insinuationer
inskränkning|inskränkningar
inspektör|inspektörer
inspelning|inspelningar
installation|installationer
installationsprogram|installationsprogram
installatör|installatörer
inställelse|inställelser
inställning|inställningar
instans|instanser
instickskort|instickskort
institut|institut
institution|institutioner
instrument|instrument
intagning|intagningar
intäkt|intäkter
integral|integraler
integralekvation|integralekvationer
integrand|integrander
integration|integrationer
integrationsgräns|integrationsgränser
integrationskonstant|integrationskonstanter
integrerad krets|integrerade kretsar
intention|intentioner
interaktion|interaktioner
interfix|interfix
interjektion|interjektioner
interjektionsfras|interjektionsfraser
interkardinalstreck|interkardinalstreck
interlokutör|interlokutörer
internetanslutning|internetanslutningar
Internetanslutning|Internetanslutningar
internetanvändare|internetanvändare
Internetanvändare|Internetanvändare
internetuppkoppling|internetuppkopplingar
Internetuppkoppling|Internetuppkopplingar
internminne|internminnen
interrobang|interrobanger
intervall|intervall
intervju|intervjuer
intrång|intrång
intresse|intressen
intressent|intressenter
introduktion|introduktioner
intryck|intryck
invånare|invånare
invändning|invändningar
invandrare|invandrare
invandring|invandringar
invasion|invasioner
invektiv|invektiv
invers|inverser
investering|investeringar
invite|inviter
IP-adress|IP-adresser
irakier|irakier
irakiska|irakiskor
iranier|iranier
iranska|iranskor
iris|irisar
irländare|irländare
irländska|irländskor
ironi|ironier
ironiker|ironiker
irritation|irritationer
is|isar
isabellastenskvätta|isabellastenskvättor
isabellatörnskata|isabellatörnskator
isberg|isberg
isbjörn|isbjörnar
ishockeypuck|ishockeypuckar
islamofobi|islamofobier
islandshäst|islandshästar
isländska|isländskor
islänning|islänningar
ism|ismer
ismås|ismåsar
isobar|isobarer
isokor|isokorer
isolani|isolanier
isolator|isolatorer
isomer|isomerer
isometri|isometrier
isomorfi|isomorfier
isomorfism|isomorfismer
isoterm|isotermer
isoton|isotoner
isotop|isotoper
israel|israeler
israeliska|israeliskor
isränna|isrännor
isskåp|isskåp
italienare|italienare
italienska|italienskor
iteration|iterationer
ivorian|ivorianer
ja|my
jack|jack
jacka|jackor
jacketkrona|jacketkronor
jägare|jägare
jagga|jaggor
jagt|jagter
jak|jakar
jakt|jakter
jaktfalk|jaktfalkar
jakthorn|jakthorn
jaktlöjtnant|jaktlöjtnanter
jam|jam
jamaican|jamaicaner
jamaicanska|jamaicanskor
jämförelse|jämförelser
jämförpris|jämförpris
jämkning|jämkningar
jämte|jämtar
jämviktsläge|jämviktslägen
jämviktsreaktion|jämviktsreaktioner
jänkare|jänkare
jänta|jäntor
januari|januarimånader
japan|japaner
japanresa|japanresor
japanska|japanskor
jargong|jargonger
jargongord|jargongord
järn|järn
järnhalt|järnhalter
järnsparv|järnsparvar
järnväg|järnvägar
järnvägsarkitekt|järnvägsarkitekter
järnvägsspår|järnvägsspår
järpe|järpar
jasmin|jasminer
jäsning|jäsningar
jätte|jättar
jättearbete|jättearbeten
jättesprång|jättesprång
jäv|jäv
jazz|jazzäpplen
jern|jern
jetmotor|jetmotorer
JK-vippa|JK-vippor
jobb|jobb
joddling|joddlingar
joggare|joggare
joggningssko|joggningsskor
joint|jointar
jojo|jojoar
jökel|jöklar
joker|jokrar
jokertecken|jokertecken
jolle|jollar
jon|joner
jonglör|jonglörer
jonne|jonnar
joppe|joppar
jord|jordar
jordanier|jordanierer
jordanska|jordanskor
jordbävning|jordbävningar
jordbruk|jordbruk
jordemoder|jordemödrar
jordglob|jordglober
jordgubbe|jordgubbar
jordgubbskompott|jordgubbskompotter
jordgubbskräm|jordgubbskrämer
jordgubbsland|jordgubbsland
jordgubbsmarmelad|jordgubbsmarmelader
jordgubbssaft|jordgubbssafter
jordgubbssorbet|jordgubbssorbeter
jordgubbssylt|jordgubbssylter
jordgubbstårta|jordgubbstårtor
jordhög|jordhögar
jordkällare|jordkällare
jordklot|jordklot
jordledning|jordledningar
jordnöt|jordnötter
jordnötsring|jordnötsringar
jordskalv|jordskalv
jorduggla|jordugglor
jos|joser
jospress|jospressar
journalist|journalister
jubilar|jubilarer
jubileum|jubileer
jude|judar
judoutövare|judoutövare
juice|juicer
juicepress|juicepressar
jukebox|jukeboxar
jul|jular
julafton|julaftnar
julaftonskväll|julaftonskvällar
julaftonsmorgon|julaftonsmorgnar
julbord|julbord
juldag|juldagar
julfirande|julfiranden
julgran|julgranar
juli|julimånader
juliamängd|juliamängder
julkaktus|julkaktusar
julklapp|julklappar
julkort|julkort
julmånad|julmånader
julsång|julsånger
julstjärna|julstjärnor
jungfru|jungfrur
jungfrubröst|jungfrubröst
jungfruresa|jungfruresor
jungfrutrana|jungfrutranor
juni|junimånader
juniorvärldsmästare|juniorvärldsmästare
juppinalle|juppinallar
jurist|jurister
juvel|juveler
juvelvårtkaktus|juvelvårtkaktusar
juxtaposition|juxtapositioner
jycke|jyckar
kabaré|kabaréer
kabel|kablar
kackalorum|kackalorum
kackerlacka|kackerlackor
kåda|kådor
kadaver|kadaver
kadi|kadier
kådis|kådisar
kafé|kaféer
kaffeautomat|kaffeautomater
kaffeböna|kaffebönor
kaffebrännare|kaffebrännare
kaffebricka|kaffebrickor
kaffebryggare|kaffebryggare
kaffebuske|kaffebuskar
kaffedrink|kaffedrinkar
kaffefilter|kaffefilter
kaffefläck|kaffefläckar
kaffegök|kaffegökar
kaffehurra|kaffehurror
kaffekanna|kaffekannor
kaffekask|kaffekaskar
kaffekassa|kaffekassor
kaffekokare|kaffekokare
kaffekopp|kaffekoppar
kaffekvarn|kaffekvarnar
kaffepanna|kaffepannor
kaffepaus|kaffepauser
kaffeplantage|kaffeplantager
kaffepulver|kaffepulver
kafferast|kafferaster
kafferep|kafferep
kaffeservis|kaffeserviser
kaffesil|kaffesilar
kaffesump|kaffesumpar
kaffesurrogat|kaffesurrogat
kaffetår|kaffetårar
kaffetarm|kaffetarmar
kaffetermos|kaffetermosar
kaffetips|kaffetips
kaffeträd|kaffeträd
kaffetunna|kaffetunnor
kägelkaktus|kägelkaktusar
kägelsnitt|kägelsnitt
kagge|kaggar
kaja|kajor
kajak|kajakar
kajuta|kajutor
kåk|kåkar
kaka|kakor
kakburk|kakburkar
kakel|kakel
kåkfarare|kåkfarare
kakmonster|kakmonster
kaktus|kaktusar
kalabalik|kalabaliker
kalanderlärka|kalanderlärkor
kalas|kalas
kalaspingla|kalaspinglor
kalif|kalifer
kalifat|kalifat
kalifornier|kalifornier
kalkon|kalkoner
kalkonfilm|kalkonfilmer
kalkonsoppa|kalkonsoppor
kalksten|kalkstenar
kalkstenslövsångare|kalkstenslövsångare
kalkylator|kalkylatorer
källa|källor
källare|källare
kallelse|kallelser
källing|källingar
kallskänk|kallskänkar
kallskänka|kallskänkor
kallsup|kallsupar
kallvattenkran|kallvattenkranar
kalorimeter|kalorimetrar
kålrot|kålrötter
kalsong|kalsonger
kalsongbadare|kalsongbadare
kålsoppa|kålsoppor
kålsupare|kålsupare
kalv|kalvar
kalvdans|kalvdanser
kalvkött|kalvkött
kam|kammar
kambodjan|kambodjaner
kambodjanska|kambodjanskor
kambräken|kambräknar
kamel|kameler
kamera|kameror
kamerunier|kamerunier
kamin|kaminer
kamkranskaktus|kamkranskaktusar
kamp|kamper
kampanj|kampanjer
kampelarkaktus|kampelarkaktusar
kampsport|kampsporter
kamrat|kamrater
kamvårtkaktus|kamvårtkaktusar
kana|kanor
kanadagås|kanadagäss
kanadensare|kanadensare
kanadensiska|kanadensiskor
kanadick|kanadicker
kanal|kanaler
kandelaberkaktus|kandelaberkaktusar
kandidat|kandidater
kändis|kändisar
kanelbulle|kanelbullar
känga|kängor
kanin|kaniner
kanji|kanjin
kånkelbär|kånkelbär
kanna|kannor
kanon|kanoner
kanonad|kanonader
kanonist|kanonister
kanot|kanoter
känsla|känslor
kansleriat|kansleriat
kant|kanter
kantarell|kantareller
kantarellsås|kantarellsåser
kantband|kantband
kantin|kantiner
kantpelarkaktus|kantpelarkaktusar
kaos|kaos
kaosteori|kaosteorier
kap|kap
kapacitans|kapacitanser
kapare|kapare
kapital|kapital
kapitalist|kapitalister
kapitel|kapitel
käpp|käppar
kapsyl|kapsyler
kapsylering|kapsyleringar
kapsylöppnare|kapsylöppnare
kapten|kaptener
kar|kar
kår|kårer
karaff|karaffer
karaktär|karaktärer
karakter|karakterer
karamellkaktus|karamellkaktusar
karbad|karbad
karbonat|karbonater
karbonylgrupp|karbonylgrupper
karboxylsyra|karboxylsyror
karda|kardor
kardemumma|kardemummor
kardinalitet|kardinaliteter
kardinalstreck|kardinalstreck
kardinaltal|kardinaltal
karet|kareter
karikatyr|karikatyrer
karisma|karismor
karl|karlar
kärl|kärl
kärlek|kärlekar
kärleksbrev|kärleksbrev
kärleksdikt|kärleksdikter
karlkläder|karlkläder
kärna|kärnor
karnivor|karnivorer
kärnkraft|kärnkrafter
kärnkraftverk|kärnkraftverk
kärnladdning|kärnladdningar
karolinasumphöna|karolinasumphönor
karp|karpar
kärr|kärr
kärrhök|kärrhökar
karriär|karriärer
kärrmaskros|kärrmaskrosor
kärrsnäppa|kärrsnäppor
kärrtärna|kärrtärnor
kart|kartar
karta|kartor
kartong|kartonger
karusell|karuseller
kärve|kärvar
kase|kasar
kassa|kassor
kassaskåpsnyckel|kassaskåpsnycklar
kasse|kassar
kassör|kassörer
kast|kast
kastanjeträd|kastanjeträd
kastparabel|kastparabler
kastrull|kastruller
kasus|kasus
kat|katte
kåta|kåtor
katakres|katakreser
katalan|katalaner
katalanska|katalanskor
katalog|kataloger
katalysator|katalysatorer
katamaran|katamaraner
katapult|katapulter
katarakt|kataraktar
katastrof|katastrofer
katedral|katedraler
kategori|kategorier
katet|kateter
katjon|katjoner
katod|katoder
katolik|katoliker
kåtslag|kåtslag
katt|katter
katta|kattor
kattdjur|kattdjur
kattdörr|kattdörrar
kattjävel|kattjävlar
kattrakande|kattrakande
kattuggla|kattugglor
kattunge|kattungar
kautschuk|kautschukar
kautshuk|kautshukar
kavalkad|kavalkader
kavel|kavlar
kavitet|kaviteter
kavring|kavringar
kebab|kebaber
kedja|kedjor
kedjebråk|kedjebråk
kedjebrev|kedjebrev
kedjekurva|kedjekurvor
kejsare|kejsare
kejsarinna|kejsarinnor
kejsarörn|kejsarörnar
kemist|kemister
kemostat|kemostater
kennel|kennlar
kentaur|kentaurer
kenyan|kenyaner
kenyanska|kenyanskor
keps|kepsar
keramiker|keramiker
keraunofobi|keraunofobier
keton|ketoner
kex|kex
khmer|khmerer
kid|kid
kids|kids
kikare|kikare
kilfläckstryckare|kilfläckstryckare
kille|killar
killing|killingar
kilo|kilo
kilobyte|kilobyte
kilogram|kilogram
kilometer|kilometer
kiloton|kiloton
kind|kinder
kines|kineser
kineseri|kineserier
kinesiska|kinesiskor
kiosk|kiosker
kioskvältare|kioskvältare
kirgiz|kirgizer
kirgiziska|kirgiziskor
kirgizistanier|kirgizistanier
kiribatier|kiribatier
kiribatiska|kiribatiskor
kiss|kisses
kisse|kissar
kissekatt|kissekatter
kissemiss|kissemissar
kista|kistor
kitslighet|kitsligheter
kittelflickare|kittelflickare
kiwimarmelad|kiwimarmelader
kjol|kjolar
kjusa|kjusor
klabb|klabbar
kladdkaka|kladdkakor
klädedräkt|klädedräkter
kläder|kläder
klädesplagg|klädesplagg
klädhängare|klädhängare
klädsel|klädslar
klädsim|klädsim
klagovisa|klagovisor
klämdag|klämdagar
klämma|klämmor
klammerparentes|klammerparenteser
klang|klanger
klänning|klänningar
klant|klantar
klåpare|klåpare
klappgröt|klappgrötar
klarinett|klarinetter
klarinettist|klarinettister
klarspråk|klarspråk
klase|klasar
klass|klasser
klassfest|klassfester
klasskamrat|klasskamrater
klassrum|klassrum
klätterstjärnkaktus|klätterstjärnkaktusar
klaustrofobi|klaustrofobier
klausul|klausuler
klave|klavar
klaviaturinstrument|klaviaturinstrument
klenod|klenoder
klimat|klimat
klimatskeptiker|klimatskeptiker
klinga|klingor
klinker|klinker
klippa|klippor
klippkaja|klippkajor
klippsparv|klippsparvar
klippsvala|klippsvalor
klirr|klirr
klo|klor
klocka|klockor
klockkaktus|klockkaktusar
klockklotkaktus|klockklotkaktusar
klockkurva|klockkurvor
klockvårtkaktus|klockvårtkaktusar
klokhuvud|klokhuvuden
klorid|klorider
klösbräda|klösbrädor
kloss|klossar
kloster|kloster
klot|klot
klotter|klotter
klöv|klövar
klovårtkaktus|klovårtkaktusar
klubb|klubbar
klubba|klubbor
klump|klumpar
klumpeduns|klumpedunsar
klusil|klusiler
klydderöv|klydderövar
klyfta|klyftor
klyka|klykor
klyvningstal|klyvningstal
knä|2
knack|knack
knäck|knäckar
knäckebröd|knäckebröd
knaffel|knafflar
knäled|knäleder
knall|knallar
knallert|knallertar
knapp|knappar
knäppare|knäppare
knäppgök|knäppgökar
knapptryckning|knapptryckningar
knasboll|knasbollar
knaster|knaster
knävelborre|knävelborrar
kned|knedar
knekt|knektar
knipa|knipor
kniphane|kniphanar
knipholk|knipholkar
kniphona|kniphonor
knippe|knippen
kniv|knivar
knivblad|knivblad
knoge|knogar
knöl|knölar
knölrotskaktus|knölrotskaktusar
knölsvan|knölsvanar
knölsydkaktus|knölsydkaktusar
knop|knopar
knopp|knoppar
knorr|knorrar
knorra|knorror
knot|knotar
knull|knull
knulldocka|knulldockor
knullgummi|knullgummin
knullkompis|knullkompisar
knullrufs|knullrufs
knut|knutar
knutpunkt|knutpunkter
knyte|knyten
knytt|knytt
ko|kor
kö|köer
kobbe|kobbar
kock|kockar
koefficient|koefficienter
koefficientmatris|koefficientmatriser
koffert|koffertar
kofot|kofötter
kognition|kognitioner
kohäger|kohägrar
kohyponym|kohyponymer
kök|kök
kokbok|kokböcker
kokill|kokiller
kokosnöt|kokosnötter
kokospalm|kokospalmer
kokott|kokotter
kokpunkt|kokpunkter
köksartikel|köksartiklar
köksbord|köksbord
köksdörr|köksdörrar
köksfläkt|köksfläktar
köksfönster|köksfönster
köksgolv|köksgolv
kökskniv|köksknivar
köksredskap|köksredskap
kökssjöborrekaktus|kökssjöborrekaktusar
kol|kol
köl|kölar
kola|kolor
kolera|koleraj
kolhydrat|kolhydrater
kolja|koljor
koll|kollar
kollegium|kollegier
kollekt|kollekter
kollektiv|kollektiv
kollokation|kollokationer
kollokvium|kollokvier
kolon|kolon
koloni|kolonier
kolonisation|kolonisationer
kolonn|kolonner
kolonnmatris|kolonnmatriser
koloratur|koloraturer
koloss|kolosser
koltrast|koltrastar
kolumn|kolumner
kolv|kolvar
kolväte|kolväten
kombattant|kombattanter
kombination|kombinationer
kombinationsspel|kombinationsspel
kombinatoriker|kombinatoriker
komedi|komedier
komet|kometer
komiker|komiker
komma|komman
kommanditbolag|kommanditbolag
kommatecken|kommatecken
kommentar|kommentarer
kommission|kommissioner
kommitté|kommittéer
kommun|kommuner
kommunikation|kommunikationer
kommunist|kommunister
kommunstyrelse|kommunstyrelser
kommutator|kommutatorer
komocka|komockor
komodovaran|komodovaraner
komp|komp
kompaktkamera|kompaktkameror
kompani|kompanier
komparation|komparationer
komparativ|komparativ
komparativform|komparativformer
kompars|komparser
kompass|kompasser
kompensation|kompensationer
kompensationspendel|kompensationspendlar
kompetens|kompetenser
kompetensutveckling|kompetensutvecklingar
kompis|kompisar
komplement|komplement
komplementmängd|komplementmängder
komplementvinkel|komplementvinklar
komplexkonjugat|komplexkonjugat
komponent|komponenter
kompositör|kompositörer
kompost|komposter
kompostering|komposteringar
kompott|kompotter
kompromiss|kompromisser
kon|koner
kön|kön
kona|konor
koncentration|koncentrationer
koncept|koncept
koncern|koncerner
kondensator|kondensatorer
kondis|kondis
kondoleans|kondoleanser
kondom|kondomer
konduktans|konduktanser
konduktivitet|konduktiviteter
konferencier|konferencierer
konferens|konferenser
konflikt|konflikter
kongle|kongler
kongress|kongresser
kongruens|kongruenser
kongruensböjning|kongruensböjningar
konjak|konjaker
konjugat|konjugat
konjunktion|konjunktioner
konjunktiv|konjunktiv
konkordans|konkordanser
konkordat|konkordat
konkurrens|konkurrenser
konkurs|konkurser
konnässans|konnässanser
konnässör|konnässörer
konnotation|konnotationer
konsekvens|konsekvenser
konselj|konseljer
konsert|konserter
konserthus|konserthus
konsistens|konsistenser
konsol|konsoler
konsonant|konsonanter
könsord|könsord
könsorgan|könsorgan
könsroll|könsroller
konst|konster
konstantinopolitanska|konstantinopolitanskor
konstighet|konstigheter
konstnär|konstnärer
konstruktion|konstruktioner
konstverk|konstverk
konsul|konsuler
konsument|konsumenter
konsumentprisindex|konsumentprisindex
kontakt|kontakter
kontaktlins|kontaktlinser
kontamination|kontaminationer
kontext|kontexter
kontinent|kontinenter
kontor|kontor
kontorsarbete|kontorsarbeten
kontrabas|kontrabasar
kontradiktion|kontradiktioner
kontraktion|kontraktioner
kontroll|kontroller
kontrollant|kontrollanter
kontrovers|kontroverser
kontur|konturer
konundrum|konundrum
konung|konungar
Konungabok|Konungaböcker
konungarike|konungariken
konvalescent|konvalescenter
konvergens|konvergenser
konversation|konversationer
konvertit|konvertiter
konvoj|konvojer
koordinat|koordinater
koordinatkurva|koordinatkurvor
koordinatmatris|koordinatmatriser
koordinatsystem|koordinatsystem
koordinatyta|koordinatytor
köp|köp
kopalkaktus|kopalkaktusar
köpare|köpare
kopia|kopior
kopiator|kopiatorer
kopieringsapparat|kopieringsapparater
kopieringsmaskin|kopieringsmaskiner
kopp|koppar
koppargruva|koppargruvor
kopparhäggmispel|kopparhäggmisplar
kopparhalt|kopparhalter
koppel|koppel
kopplad egenskap|kopplade egenskaper
kopplingsschema|kopplingsscheman
koppsten|koppstenar
kopula|kopulor
kor|kor
kör|körer
koral|koraler
korallkaktus|korallkaktusar
korda|kordor
korean|koreaner
koreanska|koreanskor
koreografi|koreografier
korg|korgar
kork|korkar
körkort|körkort
korkskalle|korkskallar
korn|korn
kornett|kornetter
kornknarr|kornknarrar
kornsparv|kornsparvar
korona|koronor
korp|korpar
korpfjäder|korpfjädrar
korpglugg|korpgluggar
korpus|korpusar
korpuskel|korpuskler
korre|korrar
korrektion|korrektioner
korrespondent|korrespondenter
korridor|korridorer
korruption|korruptioner
kors|kors
korsarm|korsarmar
korsband|korsband
körsbär|körsbär
körsbärsblomma|körsbärsblommor
körsbärskärna|körsbärskärnor
körsbärskompott|körsbärskompotter
körsbärsmarmelad|körsbärsmarmelader
körsbärssaft|körsbärssafter
körsbärssorbet|körsbärssorbeter
körsbärssylt|körsbärssyltar
korsfästelse|korsfästelser
korsfästning|korsfästningar
korsförtecken|korsförtecken
korsgång|korsgångar
korskompilator|korskompilatorer
korskyrka|korskyrkor
korsnäbb|korsnäbbar
körsnär|körsnärer
korsning|korsningar
korsningsschema|korsningsscheman
korsord|korsord
korsört|korsörter
korsriddare|korsriddare
korsstygn|korsstygn
korståg|korståg
korsväg|korsvägar
kort|kort
kortform|kortformer
korthus|korthus
kortis|kortisar
kortköp|kortköp
kortläsare|kortläsare
kortlek|kortlekar
kortsida|kortsidor
kortspel|kortspel
korttålärka|korttålärkor
korttrick|korttrick
kortvariant|kortvarianter
korv|korvar
korvbröd|korvbröd
korvfest|korvfester
korvmoj|korvmojar
korvsoppa|korvsoppor
koskälla|koskällor
kosmolog|kosmologer
kosmonaut|kosmonauter
kossa|kossor
kost|koster
kostnad|kostnader
kostym|kostymer
kött|kött
köttätare|köttätare
kotte|kottar
kotteri|kotterier
köttfärssoppa|köttfärssoppor
köttsoppa|köttsoppor
köttsort|köttsorter
kovändning|kovändningar
krabat|krabater
krabbsoppa|krabbsoppor
kraft|krafter
kraftprov|kraftprov
kraftvärmeverk|kraftvärmeverk
kraftverk|kraftverk
kraftverksdamm|kraftverksdammar
kragtrapp|kragtrappar
kråka|kråkor
kråkfot|kråkfötter
kråkfötter|kråkfötter
kräkla|kräklor
kräldjur|kräldjur
kram|kramar
kräm|krämer
krämare|krämare
kran|kranar
kranbil|kranbilar
krans|kransar
kranskaktus|kranskaktusar
kransvårtkaktus|kransvårtkaktusar
krater|kratrar
kraterskott|kraterskott
kratta|krattor
krav|krav
kravmaskin|kravmaskiner
kreatur|kreatur
kreditor|kreditorer
kremering|kremeringar
kreol|kreoler
kreolspråk|kreolspråk
kretensare|kretensare
krets|kretsar
kretsschema|kretsscheman
krig|krig
krigare|krigare
krigsskådeplats|krigsskådeplatser
kriminell|kriminella
kris|kriser
krissituation|krissituationer
kristadelfian|kristadelfianer
kristall|kristaller
kristallmottagare|kristallmottagare
krita|kritor
kriterium|kriterier
kroat|kroater
kroatiska|kroatiskor
krock|krockar
krockkudde|krockkuddar
krok|krokar
krök|krökar
krokben|krokben
krokodil|krokodiler
krokodilägg|krokodilägg
kromosfär|kromosfärer
krön|krön
krona|kronor
krönika|krönikor
Krönikebok|Krönikeböcker
kröning|kröningar
kronjuvel|kronjuveler
kronolekt|kronolekter
kronprins|kronprinsar
kronprinsessa|kronprinsessor
kropp|kroppar
kroppsdel|kroppsdelar
krösus|krösusar
kruka|krukor
krukmakare|krukmakare
krukväxt|krukväxter
krullparentes|krullparenteser
krumelur|krumelurer
krumstav|krumstavar
krusbär|krusbär
krusbärsgelé|krusbärsgeléer
krusbärskompott|krusbärskompotter
krusbärskräm|krusbärskrämer
krusbärsmarmelad|krusbärsmarmelader
krusbärspelarkaktus|krusbärspelarkaktusar
krusbärssaft|krusbärssafter
krusbärssorbet|krusbärssorbeter
krusbärssylt|krusbärssyltar
krusetår|krusetårar
krusiduller|krusiduller
krusstjärnkaktus|krusstjärnkaktusar
krux|krux
krydda|kryddor
kryddmått|kryddmått
krympslang|krympslangar
kryp|kryp
kryphål|kryphål
krypkaktus|krypkaktusar
krypopuntia|krypopuntior
kryptering|krypteringar
kryptör|kryptörer
kryss|kryss
kryssning|kryssningar
kryssprodukt|kryssprodukter
krysstag|krysstag
kub|kuber
kuban|kubaner
kubanska|kubanskor
kubikcentimeter|kubikcentimeter
kubikdecimeter|kubikdecimeter
kubikmeter|kubikmeter
kubikrot|kubikrötter
kudde|kuddar
kuddkrig|kuddkrig
kuf|kufar
kuggetal|kuggetal
kuk|kukar
kula|kulor
kuliss|kulisser
kulkärve|kulkärvar
kull|kullar
kulram|kulramar
kulspetspenna|kulspetspennor
kult|kulter
kulting|kultingar
kultur|kulturer
kulturhus|kulturhus
kulturmarkör|kulturmarkörer
kulturminister|kulturministrar
kummel|kummel
kumpan|kumpaner
kund|kunder
kundvagnsmynt|kundvagnsmynt
kung|kungar
Kungabok|Kungaböcker
kungarike|kungariken
kungörelse|kungörelser
kungsfågel|kungsfåglar
kungsörn|kungsörnar
kunskap|kunskaper
kupa|kupor
kupong|kuponger
kur|kurer
kurator|kuratorer
kurd|kurder
kurdiska|kurdiskor
kuriosum|kuriosa
kurs|kurser
kurva|kurvor
kurvintegral|kurvintegraler
kurvlängd|kurvlängder
kusin|kusiner
kusse|kussar
kust|kuster
kustlabb|kustlabbar
kustpipare|kustpipare
kustsnäppa|kustsnäppor
kut|kutar
kutta|kuttor
kuttersmycke|kuttersmycken
kuvert|kuvert
kuwaitier|kuwaitier
kuwaitiska|kuwaitiskor
kvadrat|kvadrater
kvadrataln|kvadratalnar
kvadratkomplettering|kvadratkompletteringar
kvadratmeter|kvadratmeter
kvadratmil|kvadratmil
kvadratrot|kvadratrötter
kvadrupol|kvadrupoler
kval|kval
kvalificering|kvalificeringar
kvalité|kvalitéer
kvalitet|kvaliteter
kväll|kvällar
kvalresultat|kvalresultat
kvantitet|kvantiteter
kvark|kvarkar
kvarleva|kvarlevor
kvarn|kvarnar
kvarnspel|kvarnspel
kvart|kvarter
kvartal|kvartal
kvarter|kvarter
kvartsfinal|kvartsfinaler
kvartskristall|kvartskristaller
kvartsur|kvartsur
kvasar|kvasarer
kvastsydkaktus|kvastsydkaktusar
kvävebas|kvävebaser
kverulant|kverulanter
kviga|kvigor
kvinna|kvinnor
kvinnokläder|kvinnokläder
kvinnokön|kvinnokön
kvinnomisshandlare|kvinnomisshandlare
kvinnomord|kvinnomord
kvinnonamn|kvinnonamn
kvintett|kvintetter
kvittenmarmelad|kvittenmarmelader
kvitto|kvitton
kvot|kvoter
kyckling|kycklingar
kycklingfilé|kycklingfiléer
kycklingsoppa|kycklingsoppor
kyffe|kyffen
kyl|kylar
kylskåp|kylskåp
kylskåpstermometer|kylskåpstermometrar
kymrer|kymrer
kyrka|kyrkor
kyrkbänk|kyrkbänkar
kyrkby|kyrkbyar
kyrkogård|kyrkogårdar
kyss|kyss
labb|labb
laboratorium|laboratorier
lack|lack
läcka|läckor
lada|lador
låda|lådor
ladd|ladder
laddning|laddningar
läderpaj|läderpajar
ladusvala|ladusvalor
læstadian|læstadianer
lag|lagar
låga|lågor
läge|lägen
lägenhet|lägenheter
lager|lager
läger|läger
lagerlokal|lagerlokaler
lagg|laggar
lägg|läggar
läggning|läggningar
lagman|lagmän
lågmosse|lågmossar
lågpris|lågpriser
lagrådsremiss|lagrådsremisser
lagringsmedium|lagringsmedier
lagsport|lagsporter
lågtryck|lågtryck
lajv|lajv
lakan|lakan
läkare|läkare
läkarstudent|läkarstudenter
lake|lakar
lakej|lakejer
läkemedel|läkemedel
lakonism|lakonismer
lakritsrot|lakritsrötter
läktare|läktare
lallare|lallare
lamakaktus|lamakaktusar
lamm|lamm
lammgam|lammgamar
lammunge|lammungar
lampa|lampor
lämpa|lämpor
lampett|lampetter
lampskärm|lampskärmar
lån|lån
län|län
land|länder
landgång|landgångar
landning|landningar
landningsbana|landningsbanor
landsförrädare|landsförrädare
landsförsamling|landsförsamlingar
landshövding|landshövdingar
landskamp|landskamper
landskap|landskap
landslag|landslag
landsman|landsmän
landsting|landsting
låneord|låneord
långa|långor
längd|längder
längdåkningsskida|längdåkningsskidor
längdenhet|längdenheter
längdkontraktion|längdkontraktioner
längdmått|längdmått
långfärdsskida|långfärdsskidor
långfredag|långfredagar
långpromenad|långpromenader
långsida|långsidor
långtradare|långtradare
länk|länkar
lanka|lankor
lånord|lånord
läns|länsar
länsa|länsor
lantis|lantisar
laotier|laotier
laotiska|laotiskor
lapp|lappar
läpp|läppar
lappmes|lappmesar
lappsparv|lappsparvar
lapptäcke|lapptäcken
lappuggla|lappugglor
laptop|laptopar
lår|lår
lära|läror
lärare|lärare
lärarinna|lärarinnor
lårben|lårben
lärjunge|lärjungar
lärkfalk|lärkfalkar
lärling|lärlingar
larm|larm
lärosäte|lärosäten
läroverk|läroverk
läroverksadjunkt|läroverksadjunkter
läroverksgosse|läroverksgossar
larv|larver
lås|lås
läsare|läsare
läsarinna|läsarinnor
läsk|läsk
läskedryck|läskedrycker
lasso|lasson
last|laster
läst|läster
lastbil|lastbilar
låt|låtar
lateral|lateraler
lathet|latheter
latitud|latituder
latmask|latmaskar
lättnad|lättnader
lavskrika|lavskrikor
lax|laxar
läxa|läxor
laxask|laxaskar
laxsoppa|laxsoppor
layout|layouter
LCD-skärm|LCD-skärmar
ledamot|ledamöter
ledare|ledare
ledarsida|ledarsidor
leddjur|leddjur
ledning|ledningar
ledopuntia|ledopuntior
ledsamhet|ledsamheter
ledstjärna|ledstjärnor
ledtråd|ledtrådar
leende|leenden
leg|leg
legend|legender
legering|legeringar
legitimitet|legitimiteter
legohjon|legohjon
lejon|lejon
lejoninna|lejoninnor
lejonpart|lejonparter
lejpard|lejparder
lek|lekar
lekis|lekis
lekman|lekmän
lekplats|lekplatser
lekstuga|lekstugor
lektion|lektioner
lektor|lektorer
lemma|lemma
leninist|leninister
lepton|leptoner
lera|leror
lerklining|lerkliningar
letargi|letargier
lett|letter
lettiska|lettiskor
leukocyt|leukocyter
level|levlar
lever|levrar
leverans|leveranser
leverantör|leverantörer
leverfläck|leverfläckar
leverpastej|leverpastejer
lexikograf|lexikografer
liasavlagring|liasavlagringar
libanes|libaneser
libanesiska|libanesiskor
liberalist|liberalister
liberian|liberianer
liberianska|liberianskor
libyer|libyer
libyska|libyskor
lidande|lidanden
lider|lider
lie|liar
lif|lif
ligatur|ligaturer
ligg|ligg
liggunderlag|liggunderlag
ligist|ligister
likhet|likheter
likkista|likkistor
liknelse|liknelser
likström|likströmmar
likvid|likvider
likviddag|likviddagar
lillaxel|lillaxlar
lilleputtkaktus|lilleputtkaktusar
lilltå|lilltår
lilltånagel|lilltånaglar
lim|lim
limesorbet|limesorbeter
limo|limousiner
limon|limoner
limousin|limousiner
limousine|limousiner
lina|linor
lind|lindar
lindskog|lindskogar
lingon|lingon
lingonsylt|lingonsylter
lingonvecka|lingonveckor
lingvist|lingvister
linjal|linjaler
linjärkombination|linjärkombinationer
linje|linjer
linjeintegral|linjeintegraler
linjetal|linjetal
linolja|linoljor
lins|linser
linslus|linslöss
linssoppa|linssoppor
lipsill|lipsillar
lira|liror
lisa|lisor
list|lister
lista|listor
litauer|litauer
litauiska|litauiskor
liter|liter
litografi|litografier
litosfär|litosfärer
liturg|liturger
liv|liv
livmodertapp|livmodertappar
livs|livs
livsform|livsformer
livslängd|livslängder
livsmedel|livsmedel
livsmedelsaffär|livsmedelsaffärer
livsmedelsbutik|livsmedelsbutiker
livsstil|livsstilar
ljud|ljud
ljudkort|ljudkort
ljudsystem|ljudsystem
ljungpipare|ljungpipare
ljusår|ljusår
ljuskälla|ljuskällor
ljusminut|ljusminuter
ljuspartikel|ljuspartiklar
ljussax|ljussaxar
ljussekund|ljussekunder
ljusstake|ljusstakar
lo|loar
lock|lock
lockbete|lockbeten
lockpris|lockpriser
locus|loci
lod|lod
lodis|lodisar
lodjur|lodjur
lödkolv|lödkolvar
lödning|lödningar
lof|lof
löf|löf
löfte|löften
logaritm|logaritmer
logg|loggar
logga|loggor
logi|logier
logik|logiker
logiker|logiker
lögn|lögner
lögnare|lögnare
löje|löjen
löjtnant|löjtnanter
lok|lok
lök|lökar
lokal|lokaler
lokativ|lokativer
lokatt|lokatter
lokförare|lokförare
lokomotiv|lokomotiv
lökskal|lökskal
löksoppa|löksoppor
lokus|lokus
lomma|lommor
lön|löner
Londonbo|Londonbor
löneanspråk|löneanspråk
longitud|longituder
lönn|lönnar
lönndörr|lönndörrar
lönnfack|lönnfack
lönnficka|lönnfickor
lönngång|lönngångar
lönnmord|lönnmord
lönnmördare|lönnmördare
löp|löp
löpare|löpare
lopp|lopp
loppis|loppisar
löpsedel|löpsedlar
löptid|löptider
lord|lorder
lördag|lördagar
lördagkväll|lördagkvällar
lördagmorgon|lördagmorgnar
lördagskväll|lördagskvällar
lördagsmorgon|lördagsmorgnar
lort|lortar
lortgris|lortgrisar
lösenord|lösenord
löskedräng|löskedrängar
lösning|lösningar
lösningsmängd|lösningsmängder
lösningsmedel|lösningsmedel
lössnus|lössnuser
lott|lotter
lotteri|lotterier
lov|lov
löv|löv
lövhög|lövhögar
lövmånad|lövmånader
lövopuntia|lövopuntior
lovord|lovord
lövskog|lövskogar
lövsumpskog|lövsumpskogar
lövträd|lövträd
lucia|lucior
luciatåg|luciatåg
lucka|luckor
luder|luder
luderkamp|luderkampar
luffare|luffare
luft|lufter
luftballong|luftballonger
luftförorening|luftföroreningar
luftkonditionering|luftkonditioneringar
luftslott|luftslott
luftstreck|luftstreck
luftstrupe|luftstrupar
lufttryck|lufttryck
lugg|luggar
lukt|lukter
luktskårkaktus|luktskårkaktusar
luminositet|luminositeter
lummer|lumrar
lump|lumpor
lunch|luncher
lunchtid|lunchtider
lund|lunder
lunga|lungor
lunginflammation|lunginflammationer
lunnefågel|lunnegfåglar
lur|lurar
lurendrejare|lurendrejare
lurendrejeri|lurendrejerier
lus|löss
lussekatt|lussekatter
lust|luster
lustspel|lustspel
luta|lutor
lutheran|lutheraner
luv|luvar
luxemburgare|luxemburgare
luxemburgiska|luxemburgiskor
luxemburgska|luxemburgskor
lycka|lyckor
lyckodröm|lyckodrömmar
lyktstolpe|lyktstolpar
lyra|lyror
lyrtorsk|lyrtorskar
lysdiod|lysdioder
lysing|lysingar
lyssnare|lyssnare
lyxblankett|lyxblanketter
lyxtelegram|lyxtelegram
macka|mackor
mackapär|mackapärer
madagask|madagasker
madagaskiska|madagaskiskor
maffia|maffior
måg|mågar
magasin|magasin
mage|magar
magiker|magiker
magister|magistrar
magnet|magneter
magnetfält|magnetfält
magnetskenbroms|magnetskenbromsar
magnitud|magnituder
magplask|magplask
magt|magter
mähä|mähän
mail|mail
maj|majmånader
majonnäs|majonnäser
major|majorer
majorant|majoranter
majoritet|majoriteter
majskyckling|majskycklingar
maka|makor
makak|makaker
make|makar
makedonier|makedonier
makedoniska|makedoniskor
makedonska|makedonskor
mäklare|mäklare
makron|makroner
makt|makter
maktfaktor|maktfaktorer
mal|malar
mål|mål
målare|målare
målarfärg|målarfärger
målarinna|målarinnor
målarrock|målarrockar
maldiv|maldiver
maldiviska|maldiviskor
målis|målisar
mall|mallar
malm|malmer
målmängd|målmängder
malör|malörer
målsättning|målsättningar
mältare|mältare
maltes|malteser
maltesiska|maltesiskor
måltid|måltider
målvakt|målvakter
mamma|mammor
mammografi|mammografier
mammut|mammutar
man|män
månad|månader
måndag|måndagar
måndagkväll|måndagkvällar
måndagmorgon|måndagmorgnar
måndagsexemplar|måndagsexemplar
måndagskväll|måndagskvällar
måndagsmorgon|måndagsmorgnar
mandarin|mandariner
mandat|mandat
mandel|mandlar
mandolin|mandoliner
mandolinist|mandolinister
måne|månar
manér|manér
manet|maneter
manga|mangor
mängd|mängder
mängddifferens|mängddifferenser
mangel|manglar
mångfald|mångfalder
månggifte|månggiften
månghörning|månghörningar
mangosorbet|mangosorbeter
mångsysslare|mångsysslare
manick|manicker
manifest|manifest
mankemang|mankemang
mankön|mankön
mannagrynsgröt|mannagrynsgrötar
människa|människor
människoföda|människofödor
människokropp|människokroppar
människoras|människoraser
manometer|manometrar
måns|månsar
mansgris|mansgrisar
manshora|manshoror
mansnamn|mansnamn
mansperson|manspersoner
manta|mantor
mantåg|mantåg
mantel|mantlar
mantelyta|mantelytor
manual|manualer
manufaktur|manufakturer
manus|manus
maoist|maoister
mapp|mappar
mara|maror
maräng|maränger
maratonlopp|maratonlopp
mardröm|mardrömmar
margarin|margariner
marginal|marginaler
marina|marinor
mark|marker
marka|markor
märke|märken
marken|marknar
märkesbög|märkesbögar
marketenteri|marketenterier
marknad|marknader
marknadsplats|marknadsplatser
markör|markörer
marmelad|marmelader
marmornattkaktus|marmornattkaktusar
marockan|marockaner
marockanska|marockanskor
märr|märrar
mars|marsmånader
marsch|marscher
marsian|marsianer
marsvin|marsvin
martyr|martyrer
marxist|marxister
mas|masar
mås|måsar
måsfågel|måsfåglar
måsfjäder|måsfjädrar
mashup|mashups
mask|maskar
maska|maskor
maskin|maskiner
maskinpark|maskinparker
maskot|maskotar
maskros|maskrosor
maskrosblad|maskrosblad
maskrosrot|maskrosrötter
masktörnskata|masktörnskator
maskulinum|maskuliner
massa|massor
massaker|massakrer
masscentrum|masscentra
massförstörelsevapen|massförstörelsevapen
massgrav|massgravar
massmord|massmord
massmördare|massmördare
mast|master
mästare|mästare
måste|måsten
mastodontprojekt|mastodontprojekt
masugn|masugnar
måsvinge|måsvingear
matador|matadorer
mätare|mätare
matavfall|matavfall
matbord|matbord
match|matcher
matematiker|matematiker
materia|materier
material|material
mätetal|mätetal
matlagningsredskap|matlagningsredskap
mätning|mätningar
matolja|matoljor
maträtt|maträtter
matriarkat|matriarkat
matris|matriser
matsäck|matsäckar
matsal|matsalar
matsked|matskedar
matskedsmått|matskedsmått
matstrupe|matstrupar
mått|mått
matta|mattor
måttband|måttband
matte|mattar
mattebok|matteböcker
måttenhet|måttenheter
mattermos|mattermosar
matteuppgift|matteuppgifter
mattsättning|mattsättningar
måttstock|måttstockar
matvara|matvaror
matvaruaffär|matvaruaffärer
matvarubutik|matvarubutiker
matvrak|matvrak
mausoleum|mausoleer
maximipunkt|maximipunkter
maximivärde|maximivärden
med|medar
medaljör|medaljörer
medarbetare|medarbetare
medborgare|medborgare
meddelande|meddelanden
medelhavsstenskvätta|medelhavsstenskvättor
medelhavstrut|medelhavstrutar
medelhavsväxt|medelhavsväxter
medelmåtta|medelmåttor
medelpading|medelpadingar
medelpunkt|medelpunkter
medeltidsdans|medeltidsdanser
medelvärde|medelvärden
medhjälpare|medhjälpare
mediahora|mediahoror
medicin|mediciner
medicinmanskaktus|medicinmanskaktusar
mediedrev|mediedrev
medlem|medlemmar
medlemskap|medlemskap
medlemsstat|medlemsstater
medlidande|medlidanden
medljud|medljud
medusavårtkaktus|medusavårtkaktusar
medvetande|medvetanden
medvetenhet|medvetenheter
medvetslöshet|medvetslösheter
megabyte|megabyte
mejl|mejl
mejsel|mejslar
mekaniker|mekaniker
mekanism|mekanismer
mellanbarn|mellanbarn
mellandag|mellandagar
mellandrag|mellandrag
mellanläge|mellanlägen
mellanmål|mellanmål
mellanrum|mellanrum
mellanschack|mellanschackar
mellanskov|mellanskov
mellanspett|mellanspettar
mellanting|mellanting
mellis|mellisar
melodi|melodier
melodram|melodramer
melon|meloner
melonkaktus|melonkaktusar
mem|memer
men|men
menageri|menagerier
mening|meningar
meningsskiljaktighet|meningsskiljaktigheter
menniska|menniskor
mentalsjukhus|mentalsjukhus
menuett|menuetter
meny|menyer
meristem|meristemer
merit|meriter
meritportfölj|meritportföljer
meronym|meronymer
mes|mesar
mesholk|mesholkar
meson|mesoner
mesosfär|mesosfärer
metafor|metaforer
metall|metaller
metalltråd|metalltrådar
metastas|metastaser
metates|metateser
meteor|meteorer
meteorit|meteoriter
meteoroid|meteoroider
meteorolog|meteorologer
meter|meter
metod|metoder
metodologi|metodologier
mexikan|mexikaner
mexikanska|mexikanskor
mezzosopran|mezzosopraner
middag|middagar
middagsblommekaktus|middagsblommekaktusar
midja|midjor
midnatt|midnätter
midsommarmånad|midsommarmånader
miffo|miffon
mikro|mikrovågsugnar
mikrob|mikrober
mikroliter|mikroliter
mikrometer|mikrometer
mikroorganism|mikroorganismer
mikroskop|mikroskop
mikrovågsugn|mikrovågsugnar
mil|mil
miljard|miljarder
miljardär|miljardärer
miljö|miljöer
miljon|miljoner
miljonär|miljonärer
millennium|millennier
milligram|milligram
milliliter|milliliter
millimeter|millimeter
milstolpe|milstolpar
mindmap|mindmaps
mineralolja|mineraloljor
mineralvatten|mineralvatten
minervauggla|minervaugglor
minfält|minfält
mingelbild|mingelbilder
minimipunkt|minimipunkter
minimivärde|minimivärden
miniräknare|miniräknare
ministär|ministärer
minister|ministrar
minne|minnen
minneskort|minneskort
minnesregel|minnesregler
minorant|minoranter
minoritet|minoriteter
minoritetsspråk|minoritetsspråk
minskning|minskningar
minus|minus
minustecken|minustecken
minut|minuter
minutvisare|minutvisare
misantrop|misantroper
missbruk|missbruk
missförstånd|missförstånd
missgärning|missgärningar
misshandlare|misshandlare
mission|missioner
misslyckande|misslyckanden
missnöje|missnöje
missöde|missöden
missräkning|missräkningar
misstag|misstag
misstanke|misstankar
missväxtår|missväxtår
mistel|mistlar
mistelkaktus|mistelkaktusar
mitokondrie|mitokondrier
mitra|mitror
mitt|mittar
mittback|mittbackar
mittfältare|mittfältare
mittpunkt|mittpunkter
mittspel|mittspel
mix|mixar
mjälte|mjältear
mjärde|mjärdar
mjöl|mjöler
mjölkkanna|mjölkkannor
mjölklins|mjölklinser
mjölkning|mjölkningar
mjölktand|mjölktänder
mjölnare|mjölnare
mjukis|mjukisar
mjukvara|mjukvaror
mms|mms
mö|mör
mobbing|mobbinger
möbel|möbler
mobiltelefon|mobiltelefoner
Möbiusavbildning|Möbiusavbildningar
moçambikier|moçambikier
moçambikiska|moçambikiskor
möda|mödor
moddlare|moddlare
mode|moden
modell|modeller
moder|mödrar
moderbolag|moderbolag
moderkort|moderkort
modersmål|modersmål
modeslav|modeslavar
modus|modus
möhippa|möhippor
mojäng|mojänger
möjlighet|möjligheter
moldav|moldaver
moldaviska|moldaviskor
molekyl|molekyler
mölla|möllor
moln|moln
moment|moment
momentanvärde|momentanvärden
monad|monader
monark|monarker
monarki|monarkier
monegask|monegasker
monegaskiska|monegaskiskor
mongol|mongoler
mongoliska|mongoliskor
mongolpipare|mongolpipare
mongolpiplärka|mongolpiplärkor
monogram|monogram
monoid|monoider
monolog|monologer
monom|monom
monomer|monomerer
monopol|monopol
monoteism|monoteismer
monster|monster
mönster|mönster
mönsterkort|mönsterkort
monter|montrar
montör|montörer
moped|mopeder
mopedist|mopedister
moppe|moppar
mor|mödrar
mora|moror
morakniv|moraknivar
moral|moraler
moras|moras
morbroder|morbröder
mord|mord
mördare|mördare
mordbrand|mordbränder
mordhot|mordhot
mordvapen|mordvapen
morfar|morfäder
morfem|morfem
morförälder|morföräldrar
morgon|morgnar
morgonstånd|morgonstånd
morgontidning|morgontidningar
morkulla|morkullor
mormor|mormödrar
morot|morötter
morotsfrö|morotsfrön
morotsmarmelad|morotsmarmelader
morotsskal|morotsskal
morsa|morsor
morsenyckel|morsenycklar
mört|mörtar
Mosebok|Moseböcker
moské|moskéer
mosnäppa|mosnäppor
mossa|mossor
mössa|mössor
moster|mostrar
mot|mot
motargument|motargument
motdrag|motdrag
möte|möten
mötesplats|mötesplatser
motfråga|motfrågor
motgång|motgångar
motgift|motgifter
mothugg|mothugg
motion|motioner
motionscykel|motionscyklar
motiv|motiv
motivation|motivationer
motivering|motiveringar
motlut|motlut
motor|motorer
motorcykel|motorcyklar
motorcykelpolis|motorcykelpoliser
motorfordon|motorfordon
motorgräsklippare|motorgräsklippare
motorredskap|motorredskap
motorsåg|motorsågar
motorväg|motorvägar
motsägelse|motsägelser
motsats|motsatser
motsatsord|motsatsord
motsatspar|motsatspar
motschack|motschackar
motstånd|motstånd
motståndare|motståndare
motsvarighet|motsvarigheter
mottagare|mottagare
MP3|MP3-spelare
MP3-spelare|MP3-spelare
mueddin|mueddiner
muezzin|muezziner
muff|muffar
muffin|muffin
mugg|muggar
muhammedan|muhammedaner
Muhammedbild|Muhammedbilder
mujka|mujkor
mula|mulor
mulåsna|mulåsnor
mule|mular
mullvad|mullvadar
multimeter|multimetrar
multiplexer|multiplexrar
multiplikation|multiplikationer
mun|munnar
mund|munde
mungiga|mungigor
munk|munkar
munkorg|munkorgar
munspel|munspel
muntergök|muntergökar
mupp|muppar
mur|murar
muräna|muränor
murare|murare
murarslev|murarslevar
murvel|murvlar
mus|möss
muselman|muselmaner
museum|museer
musikälskare|musikälskare
musiker|musiker
musikgrupp|musikgrupper
musikinstrument|musikinstrument
musikproducent|musikproducenter
musiksnobb|musiksnobbar
musikstil|musikstilar
musikstycke|musikstycken
muskel|muskler
musköt|musköter
muslim|muslimer
musmatta|musmattor
muspekare|muspekare
mussla|musslor
mustasch|mustascher
muta|mutor
mutation|mutationer
mutkolv|mutkolvar
mutta|muttor
mutter|muttrar
muzjik|muzjiker
MVG|MVG:n
my|my
mygel|mygel
mygga|myggor
mykolog|mykologer
myndighet|myndigheter
mynt|mynt
mynta|myntor
myon|myoner
myr|myrar
myra|myror
myriad|myriader
myrkottskaktus|myrkottskaktusar
myrsnäppa|myrsnäppor
myrspov|myrspovar
myskkranskaktus|myskkranskaktusar
myt|myter
mytologi|mytologier
näbb|näbbar
näbbsik|näbbsikar
nabo|nabor
nackdel|nackdelar
nacke|nackar
nåd|nåder
nagajka|nagajkor
nagel|naglar
nakenchock|nakenchocker
näktergal|näktergalar
nål|nålar
nalle|nallar
nålsydkaktus|nålsydkaktusar
nålvårtkaktus|nålvårtkaktusar
namibier|namibier
namibiska|namibiskor
namn|namn
nämnare|nämnare
namnbärare|namnbärare
namnbyte|namnbyten
namne|namnar
namninsamling|namninsamlingar
namnsdag|namnsdagar
nanometer|nanometer
näpst|näpster
näringsinnehåll|näringsinnehåll
näringsliv|näringsliv
narkoman|narkomaner
närmevärde|närmevärden
näs|näs
näsa|näsor
nasal|nasaler
nasare|nasare
näsborre|näsborrar
nässla|nässlor
näst|näst
näste|nästen
nästipp|nästippar
nät|nät
nätdeklarant|nätdeklaranter
nation|nationer
nationaldag|nationaldagar
nätläsare|nätläsare
nätpublikation|nätpublikationer
natt|nätter
nattduksbord|nattduksbord
natthäger|natthägrar
nattklotkaktus|nattklotkaktusar
nattklubb|nattklubbar
nattlega|nattlegor
nattreceptionist|nattreceptionister
nattskärra|nattskärror
nattstjärnkaktus|nattstjärnkaktusar
nattuggla|nattugglor
naturbarn|naturbarn
naturbegåvning|naturbegåvningar
naturfenomen|naturfenomen
naturist|naturister
naturkatastrof|naturkatastrofer
naturväsen|naturväsen
naturvetare|naturvetare
naturvetenskap|naturvetenskaper
nätverk|nätverk
nätverkskort|nätverkskort
nav|nav
näve|nävar
näver|nävrar
nazist|nazister
nebulosa|nebulosor
necessär|necessärer
nederlag|nederlag
nederländare|nederländare
nederländska|nederländskor
nedkvark|nedkvarkar
nedräkning|nedräkningar
negation|negationer
neger|negrer
negerboll|negerbollar
negerjobb|negerjobb
nej|nej
nejlika|nejlikor
nejonöga|nejonögon
nekrofil|nekrofiler
nekrofobi|nekrofobier
nektarinkärna|nektarinkärnor
neoliberalist|neoliberalister
neologism|neologismer
nepales|nepaleser
nepalesiska|nepalesiskor
nerkvark|nerkvarkar
nerv|nerver
nestorian|nestorianer
neuron|neuron
neutrino|neutriner
neutron|neutroner
neutronstjärna|neutronstjärnor
neutrum|neutrer
nevö|nevöer
newtonmeter|newtonmetrar
nia|nior
nick|nickar
nigerian|nigerianer
nigerianska|nigerianskor
nigger|niggers
nihilist|nihilister
nilgås|nilgäss
niohörning|niohörningar
niondedel|niondedelar
niondel|niondelar
nisch|nischer
nisse|nissar
nit|nitar
nittondedel|nittondedelar
nittondel|nittondelar
nivå|nivåer
nivellering|nivelleringar
nivellör|nivellörer
njure|njurar
njursten|njurstenar
njutning|njutningar
NM|NM
noaord|noaord
nod|noder
nöje|nöjen
nolla|nollor
nollåtta|nollåttor
nollmatris|nollmatriser
nollrum|nollrum
nollställe|nollställen
nomen|nomen
nomenklatur|nomenklaturer
nominering|nomineringar
nonagon|nonagoner
nonett|nonetter
noppa|noppor
nörd|nördar
nordanvind|nordanvindar
nordirländare|nordirländare
nordirländska|nordirländskor
nordkorean|nordkoreaner
nordkoreanska|nordkoreanskor
nordmaskros|nordmaskrosor
norm|normer
normalisering|normaliseringar
norn|nornir
norna|nornor
norrbagge|norrbaggar
norrlandsmaskros|norrlandsmaskrosor
norrman|norrmän
norska|norskor
nos|nosar
noshörning|noshörningar
not|noter
nöt|nötter
nota|notor
notis|notiser
nötknäppare|nötknäppare
nötkött|nötkött
nötkråka|nötkråkor
nötkreatur|nötkreatur
nötskrika|nötskrikor
notställ|notställ
nötväcka|nötväckor
nova|novor
novell|noveller
novellförfattare|novellförfattare
novellsamling|novellsamlingar
november|novembermånader
novemberkaktus|novemberkaktusar
nubb|nubbar
nubbe|nubbar
nudel|nudlar
nuffra|nuffror
nugget|nuggets
nukleon|nukleoner
nukleosid|nukleosider
nukleotid|nukleotider
nuklid|nuklider
numerus|numerus
nummer|nummer
nunnestenskvätta|nunnestenskvättor
nyans|nyanser
nyår|nyår
nyårsafton|nyårsaftnar
nyårsdag|nyårsdagar
nybörjare|nybörjare
nybörjarkurs|nybörjarkurser
nyckel|nycklar
nyckelben|nyckelben
nyckelharpa|nyckelharpor
nyckelord|nyckelord
nyckelperson|nyckelpersoner
nyckelpiga|nyckelpigor
nyckelspelare|nyckelspelare
nyctofobi|nyctofobier
nyhet|nyheter
nyhetsankare|nyhetsankare
nyhetsbyrå|nyhetsbyråer
nyhetsprogram|nyhetsprogram
nyhetstorka|nyhetstorkor
nyliberalist|nyliberalister
nylle|nyllen
nymf|nymfer
nymfeum|nymfeer
nynas|nynas
nypa|nypor
nyponmarmelad|nyponmarmelader
nyponsoppa|nyponsoppor
nypotatis|nypotatisar
nysydwalesare|nysydwalesare
nytta|nyttor
nyval|nyval
ö|öar
oavhängighet|oavhängigheter
obducent|obducenter
objekt|objekt
objektiv|objektiv
objektsform|objektsformer
obligation|obligationer
öbo|öbor
oboe|oboer
oboist|oboister
observation|observationer
obstruktion|obstruktioner
ocean|oceaner
ockerpris|ockerpriser
ockupation|ockupationer
odds|odds
ode|oden
ödeläggelse|ödeläggelser
ödemark|ödemarker
odjur|odjur
odlare|odlare
odon|odon
odör|odörer
offer|offer
offeranod|offeranoder
offert|offertar
officer|officerare1
oförrätt|oförrätter
öga|ögon
ögla|öglor
ögonblick|ögonblick
ögonbryn|ögonbryn
ögonfärg|ögonfärger
ögonfrans|ögonfransar
ögonläkare|ögonläkare
ögontjänare|ögontjänare
ögonvittne|ögonvittnen
ogräs|ogräs
ogräsmaskros|ogräsmaskrosor
ögrupp|ögrupper
ok|ok
ök|ök
öken|öknar
ökennattskärra|ökennattskärror
ökenområde|ökenområden
ökenpipare|ökenpipare
ökenstenskvätta|ökenstenskvättor
ökentrumpetare|ökentrumpetare
ökenvarfågel|ökenvarfåglar
öknamn|öknamn
ökning|ökningar
oknytt|oknytt
oktaeder|oktaedrar
oktaflexagon|oktaflexagoner
oktagon|oktagoner
oktalogi|oktalogier
oktett|oktetter
oktober|oktobermånader
oktroj|oktrojer
okunskap|okunskaper
okvädinsord|okvädinsord
okynne|okynnen
öl|öl
ölglas|ölglas
oligopeptid|oligopeptider
oligopol|oligopol
olikhet|olikheter
oliv|oliver
olivträd|olivträd
olja|oljor
oljefält|oljefält
oljud|oljud
ölmage|ölmagar
ölsinne|ölsinnen
olycka|olyckor
olyckshändelse|olyckshändelser
olycksplats|olycksplatser
olympiska spel|olympiska spel
om|om
ombud|ombud
ombudsman|ombudsmän
omdirigering|omdirigeringar
omdöme|omdömen
omega|omegan
omelett|omeletter
omfång|omfång
omgivning|omgivningar
omhändertagande|omhändertaganden
omkostnad|omkostnader
omkrets|omkretsar
omnejd|omnejder
omnivor|omnivorer
område|områden
omröstning|omröstningar
omsättning|omsättningar
omskrivande|omskrivanden
omslagspapper|omslagspapper
omställelse|omställelser
omständighet|omständigheter
omval|omval
omvandling|omvandlingar
omvändning|omvändningar
ona|onor
önation|önationer
onkogen|onkogener
onsdag|onsdagar
onsdagkväll|onsdagkvällar
onsdagmorgon|onsdagmorgnar
onsdagskväll|onsdagskvällar
onsdagsmorgon|onsdagsmorgnar
önskan|önskningar
önskebrunn|önskebrunnar
önskelista|önskelistor
önskemål|önskemål
önskning|önskningar
onyx|onyxer
opera|operor
operand|operander
operasångerska|operasångerskor
operation|operationer
operationshål|operationshål
operativsystem|operativsystem
operativsystemskärna|operativsystemskärnor
operator|operatorer
opinion|opinioner
öppettid|öppettider
öppning|öppningar
opposition|oppositioner
optimist|optimister
optimum|optimum
or|or
öra|öron
oralorgel|oralorglar
ord|ord
ordbok|ordböcker
orden|ordnar
ordförande|ordförande
ordförandeskap|ordförandeskap
ordförklaring|ordförklaringar
ordförråd|ordförråd
ordförteckning|ordförteckningar
ordinitial|ordinitialer
ordklass|ordklasser
ordlista|ordlistor
ordnare|ordnare
ordning|ordningar
ordningstal|ordningstal
ordspel|ordspel
ordspråk|ordspråk
ordstäv|ordstäv
ordval|ordval
öre|öre
Örebroare|Örebroare
oregelbundenhet|oregelbundenheter
örfil|örfilar
organ|organ
organisation|organisationer
organism|organismer
orgasm|orgasmer
orgel|orglar
orgelpipekaktus|orgelpipekaktusar
örhänge|örhängen
orienteringsklubb|orienteringsklubbar
orientseglare|orientseglare
original|original
originaltitel|originaltitelar
öring|öringar
orkan|orkaner
orkester|orkestrar
orkidé|orkidéer
orm|ormar
ormbunke|ormbunkar
ormkaktus|ormkaktusar
ormörn|ormörnar
ormvråk|ormvråkar
örn|örnar
ornament|ornament
örngott|örngott
ornitolog|ornitologer
örnvråk|örnvråkar
oro|oroj
öronläkare|öronläkare
orre|orrar
orsak|orsaker
ort|orter
ört|örter
ortnamn|ortnamn
ortolansparv|ortolansparvar
orv|orvar
os|os
OS-brons|OS-brons
OS-guld|OS-guld
OS-medalj|OS-medaljer
OS-silver|OS-silver
oskuld|oskulder
ossuarium|ossuarier
ost|ostar
östat|östater
ostburgare|ostburgare
österrikare|österrikare
osthyvel|osthyvlar
ostsmörgås|ostsmörgåsar
ostsoppa|ostsoppor
öststat|öststater
otålighet|otåligheter
otid|otider
otrygghet|otryggheter
otrygghetskänsla|otrygghetskänslor
otta|ottor
otursdag|otursdagar
oväder|oväder
ovän|ovänner
ovana|ovanor
övärld|övärldar
överadjutant|överadjutanter
överarm|överarmar
överarmsben|överarmsben
överarmsmuskel|överarmsmuskler
överblick|överblickar
överdos|överdoser
överenskommelse|överenskommelser
överkäke|överkäkar
överkorsning|överkorsningar
överleva|överlevor
övernattning|övernattningar
överraskning|överraskningar
översättare|översättare
översättning|översättningar
överslaf|överslafar
överslagshandling|överslagshandlingar
överstrykningspenna|överstrykningspennor
övertag|övertag
övertygelse|övertygelser
övervakningskamera|övervakningskameror
övervåning|övervåningar
övervikt|övervikter
ovilja|oviljor
övning|övningar
övningsämne|övningsämnen
övningskörning|övningskörningar
övningslärare|övningslärare
ovo-vegetarian|ovo-vegetarianer
oxe|oxar
oxel|oxlar
oxfilé|oxfiléer
oxid|oxider
oxymoron|oxymoroner
p-piller|p-piller
p-rulle|p-rullar
P12:a|P12:or
pack|pack
padda|paddor
påfågelspinnare|påfågelspinnare
påföljd|påföljder
påfyllning|påfyllningar
page|pager
påhitt|påhitt
påhopp|påhopp
paj|pajer
pajdeg|pajdegar
påk|påkar
paket|paket
pakistanier|pakistanier
pakistanska|pakistanskor
pålägg|pålägg
palats|palats
påle|pålar
palestinier|palestinier
palestinska|palestinskor
palett|paletter
palindrom|palindromer
pall|pallar
palm|palmer
palmtop|palmtops
päls|pälsar
pälsmössa|pälsmössor
pandeism|pandeismer
pandeist|pandeister
panel|paneler
panelhöna|panelhönor
panellängd|panellängder
panflöjt|panflöjter
pang|pang
panka|pankor
panna|pannor
pannå|pannåer
pannkaka|pannkakor
panorama|panoraman
panpizza|panpizzor
pansarvagn|pansarvagnar
panschis|panschisar
panteist|panteister
pantoffel|pantofflor
panträtt|panträtter
papegojalka|papegojalkor
påpekande|påpekanden
pappa|pappor
pappa långben|pappa långbenar
papper|papper
pappersarbete|pappersarbeten
pappershög|pappershögar
papperskasse|papperskassar
papperskorg|papperskorgar
papperslapp|papperslappar
pappkasse|pappkassar
pappskalle|pappskallar
papyrus|papyrer
par|par
parabel|parabler
paraboloid|paraboloider
parad|parader
paradigm|paradigm
paradis|paradis
paradox|paradoxer
parafras|parafraser
parafyt|parafyter
paragraf|paragrafer
paragrafryttare|paragrafryttare
paraguayan|paraguayaner
paraguayanare|paraguayanare
paraguayanska|paraguayanskor
parallellklass|parallellklasser
parallellogram|parallellogrammer
parallelltrapets|parallelltrapetser
parameter|parametrar
parametrisering|parametriseringar
paraply|paraplyer
paraplybegrepp|paraplybegrepp
paraplyorganisation|paraplyorganisationer
paraplyställ|paraplyställ
parasit|parasiter
parasoll|parasoll
pardans|pardanser
parentes|parenteser
pari|parin
paria|parior
pariserhjul|pariserhjul
parisiska|pariserskor
park|parker
parkbänk|parkbänkar
parkering|parkeringar
parkeringsbiljett|parkeringsbiljetter
parkeringsficka|parkeringsfickor
parkeringsgarage|parkeringsgarage
parkeringshus|parkeringshus
parkeringsplats|parkeringsplatser
parlamentsval|parlamentsval
pärlbandsopuntia|pärlbandsopuntior
pärlspont|pärlspontar
pärluggla|pärlugglor
pärm|pärmar
parodi|parodier
päron|päron
päronkärna|päronkärnor
päronkompott|päronkompotter
päronkräm|päronkrämer
päronsaft|päronsafter
päronsorbet|päronsorbeter
päronträd|päronträd
paroxysm|paroxysmer
part|parter
parti|2
particip|particip
partikel|partiklar
partikongress|partikongresser
partikularism|partikularismer
partiledare|partiledare
partipiska|partipiskor
partisekreterare|partisekreterare
partitur|partitur
partner|partner
party|partyn
partyorgel|partyorglar
pascha|paschor
påse|påsar
påsk|påskar
påskafton|påskaftnar
påskägg|påskägg
påskeld|påskeldar
påskhare|påskharar
påskhelg|påskhelger
påsklilja|påskliljor
påsköl|påsköl
pass|pass
passage|passager
passagerarbuss|passagerarbussar
passagerare|passagerare
passagerarflyg|passagerarflyg
passagerarsäte|passagerarsäten
passagerartåg|passagerartåg
passare|passare
passepartout|passepartouter
passform|passformer
passion|passioner
passionsfrukt|passionsfrukter
passning|passningar
passpoal|passpoaler
påstående|påståenden
pastamaskin|pastamaskiner
påste|påsteer
pastellfärg|pastellfärger
påtår|påtårar
patient|patienter
patogen|patogener
patriark|patriarker
patriot|patrioter
patron|patroner
patrull|patruller
påtryckning|påtryckningar
patt|pattar
patte|pattar
pattställning|pattställningar
paus|pauser
pava|pavor
påve|påvar
paviljong|paviljonger
pax|pax
PDF-fil|PDF-filer
pedagogik|pedagogiker
pedal|pedaler
pedant|pedanter
pedanteri|pedanterier
peddo|peddon
pedofil|pedofiler
pedofobi|pedofobier
pedometer|pedometers
pekoral|pekoral
pekskärm|pekskärmar
pelare|pelare
pelaropuntia|pelaropuntior
pen|penar
pendel|pendlar
pendeltåg|pendeltåg
penetrering|penetreringar
peng|pengar
pengar|pengar
penis|penisar
penna|pennor
pennfejd|pennfejder
pennfodral|pennfodral
penning|penningar
pennopuntia|pennopuntior
pennvässare|pennvässare
pensel|penslar
pension|pensioner
pensionär|pensionärer
pentaflexagon|pentaflexagoner
pentagon|pentagoner
pentagram|pentagram
pentalogi|pentalogier
pepp|pepp
pepparkaka|pepparkakor
pepparkaksdeg|pepparkaksdegar
pepparmynta|pepparmyntor
pepparrot|pepparrötter
peptid|peptider
perenn|perenner
perfektionist|perfektionister
perfektparticip|perfektparticip
periferi|periferier
period|perioder
periost|perioster
periskop|periskop
perkolator|perkolatorer
permis|permisar
permission|permissioner
permittent|permittenter
permutation|permutationer
peroxid|peroxider
perrong|perronger
pers|pers
persedel|persedlar
persika|persikor
persikokärna|persikokärnor
persikokompott|persikokompotter
persikomarmelad|persikomarmelader
persikosorbet|persikosorbeter
persiska|persiskor
person|personer
personal|personaler
personbil|personbilar
persondator|persondatorer
personlighet|personligheter
persontåg|persontåg
perspektiv|perspektiv
peruan|peruaner
peruanska|peruanskor
pessar|pessar
pessimist|pessimister
pestår|pestår
petimäter|petimätrar
petitess|petitesser
petition|petitioner
petmoj|petmojar
pH-indikator|pH-indikatorer
pianist|pianister
piano|pianon
piccolaflöjt|piccolaflöjter
pidginspråk|pidginspråk
piemontesiska|piemontesiskor
piga|pigor
pigga|piggor
pik|pikar
piktur|pikturer
pil|pilar
pilfink|pilfinkar
pilgrimsfalk|pilgrimsfalkar
pilla|pillor
piller|piller
pillesnopp|pillesnoppar
pilot|piloter
pilsner|pilsner
pilt|piltar
pingvin|pingviner
pinne|pinnar
pinnglass|pinnglassar
pinnvårtkaktus|pinnvårtkaktusar
pinuppa|pinuppor
pion|pioner
pipa|pipor
piparsnäppa|piparsnäppor
piplärka|piplärkor
pippa|pippor
pirat|pirater
piratpartist|piratpartister
pirog|piroger
piska|piskor
pistasch|pistascher
pistill|pistiller
pistol|pistoler
pistolskytt|pistolskyttar
pistong|pistonger
pitabröd|pitabröd
pix|picēs
pizza|pizzor
pizzabagare|pizzabagare
pizzakartong|pizzakartonger
pizzakrydda|pizzakryddor
pizzeria|pizzerior
pjäs|pjäser
pjäsbesättning|pjäsbesättningar
pjäxa|pjäxor
pladaska|pladaskor
pladuska|pladuskor
plåga|plågor
plagiat|plagiat
plakat|plakat
plånbok|plånböcker
planering|planeringar
planet|planeter
planimeter|planimetrar
planka|plankor
plånka|plånkor
planktonsik|planktonsikar
plantage|plantager
plasmaskärm|plasmaskärmar
plast|plaster
plastfolie|plastfolier
plastförpackning|plastförpackningar
plastglas|plastglas
plastmugg|plastmuggar
plastpåse|plastpåsar
plåt|plåtar
platå|platåer
plåtkråka|plåtkråkor
plats|platser
platta|plattor
plåttak|plåttak
plåttermos|plåttermosar
plattsättare|plattsättare
plattskärm|plattskärmar
plattvårtkaktus|plattvårtkaktusar
player|players
pleonasm|pleonasmer
plié|pliéer
pligg|pliggar
plikt|plikter
pling|pling
plog|plogar
plogformation|plogformationer
plomb|plomber
plommon|plommon
plommonkärna|plommonkärnor
plommonkompott|plommonkompotter
plommonkräm|plommonkrämer
plommonmarmelad|plommonmarmelader
plommonsaft|plommonsafter
plös|plösar
plunta|pluntor
plupp|pluppar
plural|pluraler
pluraländelse|pluraländelser
pluralform|pluralformer
pluralis|pluralis
plustecken|plustecken
plym|plymer
plymå|plymåer
plymvårtkaktus|plymvårtkaktusar
pneumoni|pneumonier
poäng|poäng
poängsättning|poängsättningar
poängsumma|poängsummor
pocket|pocketar
pocketbok|pocketböcker
poet|poeter
poetast|poetaster
pojke|pojkar
pojkflicka|pojkflickor
pojknamn|pojknamn
pojkvän|pojkvänner
pök|pök
pol|poler
pöl|pölar
polack|polacker
polcirkel|polcirklar
polemik|polemiker
polett|poletter
policy|policyer
polis|poliser
polisbil|polisbilar
polishelikopter|polishelikoptrar
polismotorcykel|polismotorcyklar
polisong|polisonger
polisstation|polisstationer
politiker|politiker
polkagris|polkagrisar
pollenallergi|pollenallergier
pollenallergiker|pollenallergiker
pollett|polletter
polska|polskor
polyeder|polyedrar
polyglott|polyglotter
polygon|polygoner
polygrip|polygriper
polymer|polymerer
polymerisation|polymerisationer
polynom|polynom
polypeptid|polypeptider
polytop|polytoper
pomrare|pomrare
ponny|ponnyer
pop|poper
popcorn|popcorn
popcornspåse|popcornspåsar
population|populationer
por|porer
porrbild|porrbilder
porrfilm|porrfilmer
porrgömma|porrgömmor
porslinskrona|porslinskronor
port|portar
portal|portaler
portechaise|portechaiser
portier|portierer
portion|portioner
portionssnus|portionssnuser
portmonnä|portmonnäer
porträtt|porträtt
portugis|portugiser
portugisiska|portugisiskor
portvin|portviner
posessionat|posessionater
position|positioner
positron|positroner
possibilitet|possibiliteter
post|poster
poster|postrar
postkontor|postkontor
postogram|postogram
postposition|postpositioner
potatis|potatisar
potatisskal|potatisskal
potatisskalare|potatisskalare
potens|potenser
potensfunktion|potensfunktioner
potensserie|potensserier
potentat|potentater
potential|potentialer
potentialfält|potentialfält
praktejder|praktejdrar
prakthäggmispel|prakthäggmisplar
praktik|praktiker
praktkägelkaktus|praktkägelkaktusar
praktopuntia|praktopuntior
praktsydkaktus|praktsydkaktusar
pråm|pråmar
prärie|prärier
prärielöpare|prärielöpare
präriemås|präriemåsar
prärievarg|prärievargar
präst|präster
pratbubbla|pratbubblor
pratkvarn|pratkvarnar
pratstund|pratstunder
praxis|praxisar
predikan|predikningar
predikant|predikanter
predikare|predikare
predikat|predikat
predikativ|predikativ
predikosamling|predikosamlingar
predikstol|predikstolar
preferens|preferenser
prefix|prefix
pregnans|pregnanser
preludium|preludier
premiär|premiärer
premiärlejon|premiärlejon
premiss|premisser
preparation|preparationer
preposition|prepositioner
presensform|presensformer
present|presenter
president|presidenter
presidentval|presidentval
presskonferens|presskonferenser
pressmeddelande|pressmeddelanden
pressvisning|pressvisningar
pretendent|pretendenter
preteritumform|preteritumformer
preventivmedel|preventivmedel
preventivpiller|preventivpiller
prick|prickar
prickkaktus|prickkaktusar
prideparad|prideparader
prilla|prillor
primärminne|primärminnen
primitiv|primitiver
primör|primörer
primtal|primtal
princip|principer
principal|principaler
prins|prinsar
prinsessa|prinsessor
prior|priorer
priorinna|priorinnor
prioritet|prioriteter
pris|priser
priskrig|priskrig
prismakaktus|prismakaktusar
prissänkning|prissänkningar
privatföretag|privatföretag
privatisering|privatiseringar
privatperson|privatpersoner
probersten|proberstenar
problem|problem
problemlösare|problemlösare
procedur|procedurer
procent|procent
procentare|procentare
process|processer
processor|processorer
producent|producenter
produkt|produkter
produkttecken|produkttecken
prof|prof
profession|professioner
professor|professorer
professur|professurer
profet|profeter
profit|profiter
prognos|prognoser
program|program
programledare|programledare
programmerare|programmerare
programmeringsspråk|programmeringsspråk
programvara|programvaror
programvärd|programvärdar
programvaruutvecklare|programvaruutvecklare
programvaruutveckling|programvaruutvecklingar
projekt|projekt
projektarbete|projektarbeten
projektil|projektiler
projektledare|projektledare
projektor|projektorer
promenad|promenader
promenix|promenixer
promille|promille
promotor|promotorer
propeller|propellrar
proposition|propositioner
proselyt|proselyter
prost|prostar
protein|proteiner
protes|proteser
protest|protester
protokoll|protokoll
protologism|protologismer
protolysreaktion|protolysreaktioner
proton|protoner
prov|prov
provins|provinser
prövning|prövningar
provokatör|provokatörer
prutgås|prutgäss
pryl|prylar
prylbög|prylbögar
pryttel|pryttlar
psalm|psalmer
psaltare|psaltare
pseudovetenskap|pseudovetenskaper
psykolog|psykologer
psykologi|psykologier
pub|pubar
publik|publiker
publikation|publikationer
publikum|publikum
puck|puckar
pucko|puckon
pudding|puddingar
pudel|pudlar
pudelvalp|pudelvalpar
puffert|puffertar
puka|pukor
pulla|pullor
pulpet|pulpeter
pulver|pulver
puma|pumor
pumpa|pumpor
pumpasoppa|pumpasoppor
pundare|pundare
pungdjur|pungdjur
pungmes|pungmesar
punka|punkor
punkare|punkare
punkt|punkter
punktering|punkteringar
punktladdning|punktladdningar
punktlighet|punktligheter
punktlista|punktlistor
purjolök|purjolökar
purpurhäger|purpurhägrar
purpuropuntia|purpuropuntior
puss|pussar
pussel|pussel
pusselbit|pusselbitar
pust|pustar
pustel|pustler
putell|puteller
pyramid|pyramider
pyrofobi|pyrofobier
pyssling|pysslingar
pytt i panna|pytt i pannor
pyttipanna|pyttipannor
q-märkning|q-märkningar
quenell|queneller
quiche|quicher
quisling|quislingar
quislingregering|quislingregeringar
qvadersten|qvaderstenar
qvadrat|qvadrater
qvadrataln|qvadratalnar
qvadratmil|qvadratmil
qval|qval
qvalster|qvalster
qvarn|qvarnar
qvinna|qvinnor
rabarberkompott|rabarberkompotter
rabarberkräm|rabarberkrämer
rabarbermarmelad|rabarbermarmelader
rabarberpaj|rabarberpajer
rabarbersaft|rabarbersafter
rabatt|rabatter
rack|rack
racka|rackaor
räcka|räckor
rackabajsare|rackabajsare
rackartyg|rackartyg
racket|racketar
rad|rader
råd|råd
radardiagram|radardiagram
räddare|räddare
räddning|räddningar
räddningskår|räddningskårer
radekvivalens|radekvivalenser
radergummi|radergummin
radering|raderingar
rådgivare|rådgivare
rådhus|rådhus
rådhusrätt|rådhusrätter
radian|radianer
radie|radier
radikal|radikaler
radio|radior
radiomottagare|radiomottagare
radiosändare|radiosändare
radiotal|radiotal
rädisa|rädisor
rådjur|rådjur
radmatris|radmatriser
rädsla|rädslor
räf|räfvar
räffla|räfflor
räfsa|räfsor
rågbröd|rågbröd
råge|rågar
ragg|ragg
raggopuntia|raggopuntior
raise|raisar
raka|rakor
råka|råkor
rakapparat|rakapparater
räknare|räknare
räknedosa|räknedosor
räknefel|räknefel
räknehäfte|räknehäften
räknemaskin|räknemaskiner
räkneord|räkneord
räkneuppgift|räkneuppgifter
rakning|rakningar
räkning|räkningar
raljeri|raljerier
rall|rallar
rallare|rallare
rallarsving|rallarsvingar
rallhäger|rallhägrar
räls|rälsar
ram|ramar
ramaskri|ramaskrin
rämna|rämnor
ramsa|ramsor
ramtid|ramtider
rån|rån
rand|ränder
randpunkt|randpunkter
randvillkor|randvillkor
ranka|rankor
ränna|rännor
rännil|rännilar
rännsten|rännstenar
ränta|räntor
rap|rap
rapan|rapanden
rapp|rapp
rapphöna|rapphönor
rapport|rapporter
rapsod|rapsoder
ras|raser
raseriutbrott|raseriutbrott
rasist|rasister
rast|raster
rastplats|rastplatser
rätblock|rätblock
ratt|rattar
råtta|råttor
rättegång|rättegångar
rättegångsdag|rättegångsdagar
rättelse|rättelser
rättesnöre|rättesnören
rattfylla|rattfyllor
rättighet|rättigheter
rauk|raukar
räv|rävar
råvara|råvaror
ravin|raviner
rävsvanskaktus|rävsvanskaktusar
re-raise|re-raisar
rea|reor
reaktans|reaktanser
reaktion|reaktioner
reaktionsflygplan|reaktionsflygplan
reaktionsformel|reaktionsformler
reaktionsmotor|reaktionsmotorer
realisation|realisationer
realisationsvinst|realisationsvinster
realist|realister
realitet|realiteter
reamotor|reamotorer
reaplan|reaplan
reavinst|reavinster
rebell|rebeller
recensent|recensenter
recension|recensioner
recept|recept
receptbok|receptböcker
receptionist|receptionister
recett|recetter
recettagare|recettagare
recidiv|recidiv
recitation|recitationer
redaktion|redaktioner
redaktör|redaktörer
rede|reden
redigering|redigeringar
redigeringskommentar|redigeringskommentarer
redigeringsruta|redigeringsrutor
redning|redningar
redogörelse|redogörelser
redovisning|redovisningar
redoxreaktion|redoxreaktioner
redskap|redskap
referens|referenser
referenslitteratur|referenslitteraturer
referensverk|referensverk
reflexräddning|reflexräddningar
reflexväst|reflexvästar
refräng|refränger
regel|reglar
regent|regenter
regering|regeringar
regeringschef|regeringschefer
regim|regimer
region|regioner
regissör|regissörer
register|register
reglering|regleringar
regn|regn
regnbåge|regnbågar
regnbågsbarn|regnbågsbarn
regnbågsforell|regnbågsforeller
regnbågskaktus|regnbågskaktusar
regndroppe|regndroppar
regression|regressioner
rehabilitering|rehabiliteringar
reinkarnation|reinkarnationer
reklam|reklamer
reklampelare|reklampelare
rekommendation|rekommendationer
rekord|rekord
rekryt|rekryter
rektangel|rektanglar
rektascension|rektascensioner
rektor|rektorer
rekursion|rekursioner
relä|reläer
relation|relationer
relationsdatabas|relationsdatabaser
release|releaser
religion|religioner
rem|remmar
remi|remier
renässansdans|renässansdanser
rendezvous|rendezvous
rengöring|rengöringar
renons|renonser
rep|rep
repa|repor
reparatör|reparatörer
repertoar|repertoarer
repertoarteater|repertoarteatrar
repetition|repetitioner
reportage|reportage
reporter|reportrar
representation|representationer
repressalie|repressalier
reprimand|reprimander
repris|repriser
reptil|reptiler
republik|republiker
repulsion|repulsioner
reraise|reraisar
resa|resor
resande|resande
resår|resår
rese|resar
research|researches
resenär|resenärer
reservation|reservationer
reservoar|reservoarer
reservoarpenna|reservoarpennor
resistans|resistanser
resistivitet|resistiviteter
resistor|resistorer
resonemang|resonemang
resonerande|resoneranden
respass|respass
respirator|respiratorer
respit|respiter
respondent|respondenter
rest|rester
restaurang|restauranger
restaurant|restaurants
restaurering|restaureringar
resultant|resultanter
resultat|resultat
resumé|resuméer
resurs|resurser
retardation|retardationer
retsticka|retstickor
retur|returer
reva|revor
revben|revben
revision|revisioner
revisor|revisorer
revolution|revolutioner
revolver|revolvrar
revy|revyer
ria|rior
ribbpelarkaktus|ribbpelarkaktusar
ribbsjöborrekaktus|ribbsjöborrekaktusar
ribbskott|ribbskott
ribbstol|ribbstolar
rike|riken
riksbank|riksbanker
riksdag|riksdagar
riksdagsledamot|riksdagsledamöter
riksdagsman|riksdagsmän
riksdagsval|riksdagsval
riktning|riktningar
riktningsderivata|riktningsderivator
riktningskoefficient|riktningskoefficienter
riktningsvektor|riktningsvektorer
rim|rim
rimord|rimord
ring|ringar
ringand|ringänder
ringandshane|ringandshanar
ringandshona|ringandshonor
ringdans|ringdanser
ringduva|ringduvor
ringklocka|ringklockor
ringsignal|ringsignaler
ringtrast|ringtrastar
ris|ris
risgrynsgröt|risgrynsgrötar
rishög|rishögar
risk|risker
rispa|rispor
rit|riter
ritning|ritningar
ritual|ritualer
riveri|riverier
rivieraopuntia|rivieraopuntior
rivjärn|rivjärn
rö|2
robe|rober
robot|robotar
rock|rockar
rocka|rockor
rockad|rockader
rockring|rockringar
rödbena|rödbenor
rödbeta|rödbetor
roddbåt|roddbåtar
rödfalk|rödfalkar
rödhake|rödhakar
röding|rödingar
rödspov|rödspovar
rödstjärt|rödstjärtar
rödstrumpa|rödstrumpor
rödtopp|rödtoppar
rödvin|rödviner
rödvinbärsgelé|rödvinbärsgeléer
rödvinbärskräm|rödvinbärskrämer
rödvinbärssaft|rödvinbärssafter
rödvingetrast|rödvingetrastar
röfvare|röfvare
rökeri|rökerier
roll|roller
rom|romer
roman|romaner
romanförfattare|romanförfattare
romansallat|romansallater
romb|romber
rön|rön
rondell|rondeller
rondellhund|rondellhundar
rönnbärsgelé|rönnbärsgeléer
rop|rop
rör|rör
röra|röror
rörbockning|rörbockningar
rördrom|rördrommar
rörelse|rörelser
rörelsemängd|rörelsemängder
rörhöna|rörhönor
rörmokare|rörmokare
rörmottagare|rörmottagare
ros|rosor
röse|rösen
rosenfink|rosenfinkar
rosenkranskaktus|rosenkranskaktusar
rosenmås|rosenmåsar
rosensjöborrekaktus|rosensjöborrekaktusar
rosenstare|rosenstarer
rosentärna|rosentärnor
rosett|rosetter
rosévin|roséviner
roskarl|roskarlar
röst|röster
rostand|roständer
rostandshane|rostandshanar
rostandshona|rostandshonor
röstfiske|röstfisken
rostgumpsvala|rostgumpsvalor
rostnate|borstnatar
rostpelarkaktus|rostpelarkaktusar
röstskådespelare|röstskådespelare
rostskogstrast|rostskogstrastar
rostsparv|rostsparvar
rosväxt|rosväxter
rot|rötter
röta|rötor
rötägg|rötägg
rotation|rotationer
rotationskropp|rotationskroppar
rotationsyta|rotationsytor
rotekvation|rotekvationer
rotunda|rotundor
rotuttryck|rotuttryck
router|routrar
rov|rov
röv|rövar
rövare|rövare
rövhål|rövhål
rovvattenloppa|rovvattenloppor
rubank|rubankar
rubinkaktus|rubinkaktusar
rubinvårtkaktus|rubinvårtkaktusar
rubrik|rubriker
ruckel|ruckel
rudbeckia|rudbeckior
ruff|ruffar
rulle|rullar
rullebör|rullebörar
rullgänga|rullgängor
rullskridsko|rullskridskor
rullstol|rullstolar
rulltårta|rulltårtor
rulltrappa|rulltrappor
rum|rum
rumän|rumäner
rumänska|rumänskor
rumpa|rumpor
runa|runor
runda|rundor
rundpolska|rundpolskor
rundstav|rundstavar
runstycke|runstycken
ruptur|rupturer
rus|rus
rusk|rusk
russin|russin
russinfinger|russinfingrar
ruta|rutor
rutnät|rutnät
rutschkana|rutschkanor
ruva|ruvor
rya|ryor
ryck|ryck
rygg|ryggar
rygga|ryggor
ryggrad|ryggrader
ryggsäck|ryggsäckar
rykte|rykten
rymd|rymder
rymdfarare|rymdfarare
rymdhäxa|rymdhäxor
rymdhjälte|rymdhjältar
rymdmått|rymdmått
rymdmonster|rymdmonster
rymdvarelse|rymdvarelser
rymning|rymningar
rynka|rynkor
rysare|rysare
ryska|ryskor
rysning|rysningar
ryss|ryssar
så|såar
sabbat|sabbater
sabbatsår|sabbatsår
sabel|sablar
sabotage|sabotage
saccosäck|saccosäckar
säck|säckar
säckstation|säckstationer
sadel|sadlar
sadelpunkt|sadelpunkter
sädesärla|sädesärlor
sädescell|sädesceller
sädesfält|sädesfält
sädesslag|sädesslag
sädesuttömning|sädesuttömningar
sädgås|sädgäss
sadist|sadister
sadomasochist|sadomasochister
saffransbulle|saffransbullar
safir|safirer
saft|safter
saftglas|saftglas
saftmaja|saftmajor
såg|sågar
saga|sagor
sägen|sägner
sagesman|sagesmän
sågspån|sågspån
saguarokaktus|saguarokaktusar
sajt|sajter
sak|saker
säkerhetsåtgärd|säkerhetsåtgärder
säkerhetsbälte|säkerhetsbälten
säkerhetsventil|säkerhetsventiler
saköre|saköre
sakrament|sakrament
sal|salar
säl|sälar
salamander|salamandrar
sälg|sälgar
sälgskog|sälgskogar
säljare|säljare
sallad|sallader
salladsbestick|salladsbestick
sallat|sallater
salong|salonger
salskrake|salskrakar
sälta|sältor
salthalt|salthalter
saltkar|saltkar
saluhall|saluhallar
salva|salvor
salvadoran|salvadoraner
salvadoranska|salvadoranskor
samarbete|samarbeten
samba|sambor
samband|samband
sambo|sambor
same|samer
samfund|samfund
samhälle|samhällen
samköp|sammköpen
samkväm|samkväm
samlag|samlag
samlare|samlare
samling|samlingar
sammäld|sammälder
sammanfogning|sammanfogningar
sammanhang|sammanhang
sammansättning|sammansättningar
sammanställning|sammanställningar
sammansvärjning|sammansvärjningar
sammanträffande|sammanträffanden
samoan|samoaner
sampolymer|sampolymerer
samsikt|samsiktar
samtal|samtal
samtalsämne|samtalsämne
samtid|samtider
Samuelsbok|Samuelsböcker
samuraj|samurajer
samverkan|samverkan
samvete|samveten
sandalett|sandaletter
sändare|sändare
sändebud|sändebud
sandklotkaktus|sandklotkaktusar
sandlåda|sandlådor
sandlöpare|sandlöpare
sandmaskros|sandmaskrosor
sandpapper|sandpapper
sandsik|sandsikar
sandsnäppa|sandsnäppor
sandstrand|sandstränder
sandtärna|sandtärnor
sång|sånger
säng|sängar
sångare|sångare
sånglärka|sånglärkor
sångsvan|sångsvanar
sänka|sänkor
sänkning|sänkningar
sanktion|sanktioner
sanning|sanningar
sanningstabell|sanningstabeller
sannolikhet|sannolikheter
såpa|såpor
saprofyt|saprofyter
sår|sår
särbo|särbor
sardiska|sardiskor
särdrag|särdrag
sarkasm|sarkasmer
sarkofag|sarkofager
särkvark|särkvarkar
särskrivning|särskrivningar
sås|såser
såsfläck|såsfläckar
säsong|säsonger
såsslev|såsslevar
säte|säten
satellit|satelliter
satisfaktion|satisfaktioner
sats|satser
satsdel|satsdelar
satsning|satsningar
satsradning|satsradningar
sätt|sätt
sätthake|sätthakar
sävsparv|sävsparvar
sax|saxar
saxblad|saxblad
saxofon|saxofoner
saxofonist|saxofonister
scanner|scannrar
scen|scener
scenografi|scenografier
schablon|schabloner
schabrak|schabrak
schack|schackspel
schack matt|schack mattar
schackbräde|schackbräden
schackklocka|schackklockor
schackmatt|schackmattar
schackmatta|schackmattor
schackpatt|schackpattar
schackpjäs|schackpjäser
schackruta|schackrutor
schackspel|schackspel
schackteori|schackteorier
schäfer|schäfrar
schäfervalp|schäfervalpar
schakal|schakaler
schalottenlök|schalottenlökar
scharlakanssydkaktus|scharlakanssydkaktusar
scharlakansvårtkaktus|scharlakansvårtkaktusar
schema|scheman
schism|schismer
schlager|schlagrar
schweizare|schweizare
schweiziska|schweiziskor
sciofobi|sciofobier
scout|scouter
scoutförbund|scoutförbund
scoutkår|scoutkårer
scoutläger|scoutläger
sebra|sebror
sedan|sedaner
sedel|sedlar
sedelbunt|sedelbuntar
sedvänja|sedvänjor
sefyr|sefyrer
segel|segel
segelbåt|segelbåtar
segelplan|segelplan
seger|segrar
seglats|seglatser
sej|sejar
sejd|sejder
sekelskifte|sekelskiften
sekretär|sekretärer
sekreterare|sekreterare
sekt|sekter
sektor|sektorer
sekund|sekunder
sekundärkommun|sekundärkommuner
sekundvisare|sekundvisare
selma|selmor
semester|semestrar
semifakultet|semifakulteter
semifinal|semifinaler
semigrupp|semigrupper
semikolon|semikolon
semla|semlor
sena|senor
senap|senaper
sensmoral|sensmoraler
sensor|sensorer
september|septembermånader
septett|septetter
serb|serber
serbier|serbier
serbiska|serbiskor
serenad|serenader
serendipitet|serendipiteter
serie|serier
seriefigur|seriefigurer
seriemord|seriemord
seriemördare|seriemördare
seriositet|seriositeter
serotoninåterupptagshämmare|serotoninåterupptagshämmare
serve|servar
serveäss|serveäss
server|servrar
servering|serveringar
serveroperativsystem|serveroperativsystem
servett|servetter
servitut|servitut
sevärdhet|sevärdheter
sex|sexes
sexa|sexor
sexhörning|sexhörningar
sexist|sexister
sexpack|sexpack
sextant|sextanter
sextett|sextetter
sextondedel|sextondedelar
sextondel|sextondelar
sfär|sfärer
shiamuslim|shiamuslimer
show|shower
SI-enhet|SI-enheter
siames|siameser
siare|siare
sicksack|sicksackar
sida|sidor
sidensvans|sidensvansar
sidensvanshane|sidensvanshanar
sidensvanshona|sidensvanshonor
sidoprojekt|sidoprojekt
sierska|sierskor
siffra|siffror
signal|signaler
signalement|signalement
sik|sikar
siklöja|siklöjor
sikt|siktar
siktbröd|siktbröd
siktmjöl|siktmjöl
sil|silar
silkeshäger|silkeshägrar
silkesvårtkaktus|silkesvårtkaktusar
sill|sillar
sillgrissla|sillgrisslor
sillkung|sillkungar
silltrut|silltrutar
sillval|sillval
silver|silver
silvergrogg|silvergroggar
silvergruva|silvergruvor
silverhalt|silverhalter
silvermedalj|silvermedaljer
silverpelarkaktus|silverpelarkaktusar
silverpenning|silverpenningar
silversydkaktus|silversydkaktusar
silvertärna|silvertärnor
silvervårtkaktus|silvervårtkaktusar
simning|simningar
simsnäppa|simsnäppor
singel|singlar
singular|singular
singularis|singularis
sinka|sinkor
sinn|sinn
sinne|sinnen
sinnebild|sinnebilder
sinnesförändring|sinnesförändringar
sinolog|sinologer
sinusfunktion|sinusfunktioner
sipp|sippar
sippa|sippor
sittbrunn|sittbrunnar
sittplats|sittplatser
situation|situationer
sjal|sjalar
själ|själar
självbiografi|självbiografier
självdistans|självdistanser
självförtroende|självförtroenden
självkänsla|självkänslor
självljud|självljud
självmord|självmord
självmordsbombare|självmordsbombare
självporträtt|självporträtt
självständighet|självständigheter
sjättedel|sjättedelar
sjö|sjöar
sjöborrekaktus|sjöborrekaktusar
sjöfågel|sjöfåglar
sjöhäst|sjöhästar
sjok|sjok
sjöman|sjömän
sjöodjur|sjöodjur
sjöorre|sjöorrar
sjörövare|sjörövare
sjöstjärnekaktus|sjöstjärnekaktusar
sjua|sjuor
sjuhörning|sjuhörningar
sjuka|sjukor
sjukdom|sjukdomar
sjukhus|sjukhus
sjuksköterska|sjuksköterskor
sjuksyster|sjuksystrar
sjundedel|sjundedelar
sjurygg|sjuryggar
sjuttondedel|sjuttondedelar
sjuttondel|sjuttondelar
skäck|skäckar
skada|skador
skadegörare|skadegörare
skådeplats|skådeplatser
skådespel|skådespel
skådespelare|skådespelare
skådespeleri|skådespelerier
skadestånd|skadestånd
skadskjutning|skadskjutningar
skaffel|skafflar
skafferi|skafferier
skaft|skaft
skägg|skägg
skäggdopping|skäggdoppingar
skäggmes|skäggmesar
skäggtärna|skäggtärnor
skäkta|skäktor
skal|skal
skål|skålar
skäl|skäl
skala|skalor
skalär|skalärer
skalärfält|skalärfält
skalärprodukt|skalärprodukter
skald|skalder
skaldeart|skaldearter
skalfaktor|skalfaktorer
skalk|skalkar
skall|skall
skäll|skäll
skålla|skållor
skällande|skällanden
skalle|skallar
skällning|skällningar
skällsord|skällsord
skälm|skälmar
skålsydkaktus|skålsydkaktusar
skalvsjö|skalvsjöar
skämt|skämt
Skånepåg|Skånepågar
skåning|skåningar
skanner|skannrar
skånska|skånskor
skåp|skåp
skapelse|skapelser
skapnad|skapnader
skåra|skåror
skära|skäror
skärfläcka|skärfläckor
skärgård|skärgårdar
skärm|skärmar
skärmsläckare|skärmsläckare
skärmupplösning|skärmupplösningar
skärmytsling|skärmytslingar
skärningspunkt|skärningspunkter
skärp|skärp
skärpa|skärpor
skärpiplärka|skärpiplärkor
skärsår|skärsår
skärseld|skärseldar
skärsnäppa|skärsnäppor
skarv|skarvar
skarvsladd|skarvsladdar
skata|skator
skatfjäder|skatfjädrar
skatgök|skatgökar
skatt|skatter
skattebetalare|skattebetalare
skatteindrivare|skatteindrivare
skatteparadis|skatteparadis
skavank|skavanker
sked|skedar
skedand|skedänder
skedandshane|skedandshanar
skedandshona|skedandshonor
skede|skeden
skedstork|skedstorkar
skeende|skeenden
skeleton|skeletons
skelett|skelett
sken|sken
skena|skenor
skenben|skenben
skepnad|skepnader
skepp|skepp
skeptiker|skeptiker
skick|skick
skicklighet|skickligheter
skida|skidor
skidåkare|skidåkare
skidåkning|skidåkningar
skidbacke|skidbackar
skidspets|skidspetsar
skidvalla|skidvallor
skiftläge|skiftlägen
skiftnyckel|skiftnycklar
skiljemynt|skiljemynt
skilling|skillingar
skillingtryck|skillingtryck
skillnad|skillnader
skilsmässa|skilsmässor
skinka|skinkor
skinn|skinn
skinnsort|skinnsorter
skit|skitar
skitstövel|skitstövlar
skiva|skivor
skivbolag|skivbolag
skjorta|skjortor
skjul|skjul
skjut|skjut
skjutmått|skjutmått
skjuts|skjutsar
sko|skor
skoaffär|skoaffärer
skoborste|skoborstar
skobutik|skobutiker
skog|skogar
skogsbärsmarmelad|skogsbärsmarmelader
skogsbrand|skogsbränder
skogsduva|skogsduvor
skogslönn|skogslönnar
skogssnäppa|skogssnäppor
skogsstig|skogsstigar
skohorn|skohorn
skojare|skojare
skola|skolor
skolämne|skolämnen
skolbarn|skolbarn
skolbuss|skolbussar
sköld|sköldar
sköldpadda|sköldpaddor
skolfröken|skolfröknar
skolkamrat|skolkamrater
skolklass|skolklasser
skolmästare|skolmästare
skolmatt|skolmattar
skolmördare|skolmördare
skolresa|skolresor
skolungdom|skolungdomar
skomakare|skomakare
skönhet|skönheter
skönhetstävling|skönhetstävlingar
skördemånad|skördemånader
skorem|skoremmar
skorpa|skorpor
skorsten|skorstenar
skorstensseglare|skorstensseglare
skosnöre|skosnören
skoter|skotrar
skotofobi|skotofobier
skott|skott
skottår|skottår
skottdag|skottdagar
skotte|skottar
skottkärra|skottkärror
skräckfilm|skräckfilmer
skräckis|skräckisar
skräll|skrällar
skrälle|skrällen
skråma|skråmor
skrammel|skrammel
skränfock|skränfockar
skräntärna|skräntärnor
skrapa|skrapor
skratt|skratt
skrattmås|skrattmåsar
skrev|skrev
skribent|skribenter
skridsko|skridskor
skrift|skrifter
skrik|skrik
skrika|skrikor
skriptum|skriptum
skrivare|skrivare
skrivblock|skrivblock
skrivbok|skrivböcker
skrivbord|skrivbord
skrivbordsunderlägg|skrivbordsunderlägg
skrivmaskin|skrivmaskiner
skrivstil|skrivstilar
skrivtyg|skrivtyg
skrot|skrotar
skrubba|skrubbor
skrud|skrudar
skrufångare|skrufångare
skrupel|skrupler
skrutt|skruttar
skruv|skruvar
skruvångare|skruvångare
skruvdragare|skruvdragare
skruvmejsel|skruvmejslar
skruvnyckel|skruvnycklar
skruvvårtkaktus|skruvvårtkaktusar
skrynkelkaktus|skrynkelkaktusar
skrytsamhet|skrytsamheter
skuffelse|skuffelser
skugga|skuggor
skuggbudget|skuggbudgetar
skuld|skulder
skuldenär|skuldenärer
skuldkänsla|skuldkänslor
skulptur|skulpturer
skummis|skummisar
skumpa|skumpor
skur|skurar
skuta|skutor
skvallerbytta|skvallerbyttor
skvallertidning|skvallertidningar
skvattram|skvattram
sky|skyar
skydd|skydd
skyddsmärke|skyddsmärken
skyddsombud|skyddsombud
skyldighet|skyldigheter
skylt|skyltar
skyltfönster|skyltfönster
skymning|skymningar
skymningsläge|skymningslägen
skyskrapa|skyskrapor
slå|slåar
sladd|sladdar
sladdbarn|sladdbarn
slaf|slafar
slafsa|slafsaor
slag|slag
slägga|släggor
slagsmål|slagsmål
slagträ|slagträn
slaguggla|slagugglor
slagverksinstrument|slagverksinstrument
släkt|släkter
släkte|släkten
släkting|släktingar
slaktmånad|slaktmånader
släktträd|släktträd
släktträff|släktträffar
slalomskida|slalomskidor
slampa|slampor
slånbär|slånbär
slånbärskärna|slånbärskärnor
slånbärssaft|slånbärssafter
slang|slangar
släng|slängar
slangord|slangord
släp|släp
släpfordon|släpfordon
slapptask|slapptaskar
slarver|slarvrar
slarvfel|slarvfel
slas|slasar
slase|slasar
slashas|slashasar
slav|slavar
slickepinne|slickepinnar
slida|slidor
slidkrans|slidkransar
slingerkaktus|slingerkaktusar
slinka|slinkor
slips|slipsar
slits|slitsar
slöjd|slöjder
slöjdlärare|slöjdlärare
slott|slott
slovak|slovaker
slovakiska|slovakiskor
slovenska|slovenskor
slump|slumpar
slumpsida|slumpsidor
slunga|slungor
sluss|slussar
slut|slut
slutare|slutare
slutledningsförmåga|slutledningsförmågor
slutprodukt|slutprodukter
slutsats|slutsatser
slutskede|slutskeden
slutspel|slutspel
slyna|slynor
smädare|smädare
smädelse|smädelser
smådopping|smådoppingar
småfel|småfel
småföretagare|småföretagare
småfranska|småfranskor
smak|smaker
smakämne|smakämnen
smaklök|smaklökar
smaksak|smaksaker
småländska|småländskor
smålänning|smålänningar
smälla|smällor
smällare|smällare
smålom|smålommar
smälta|smältor
smältpunkt|smältpunkter
smältvärme|smältvärmen
småmynt|småmynt
smaragdkaktus|smaragdkaktusar
småsak|småsaker
småskrake|småskrakar
småsnäppa|småsnäppor
småspov|småspovar
småstad|småstäder
småtärna|småtärnor
småtrapp|småtrappar
smed|smeder
smedja|smedjor
smeknamn|smeknamn
smet|smeter
smil|smil
smilis|smilisar
smitning|smitningar
smitta|smittor
smittämne|smittämnen
smolt|smolt
smörblomma|smörblommor
smörgås|smörgåsar
smörgåsbord|smörgåsbord
smörja|smörjor
smörkniv|smörknivar
sms|sms
sms-lån|sms-lån
SMS-lån|SMS-lån
smula|smulor
smultron|smultron
smultronsaft|smultronsafter
smultronsorbet|smultronsorbeter
smutsgam|smutsgamar
smutt|smuttar
smycke|smycken
smyg|smygar
smygbög|smygbögar
snabbis|snabbisar
snabel-a|snabel-a:n
snackis|snackisar
snäcktrappa|snäcktrappor
snålis|snålisar
snåljåp|snåljåpar
snäppa|snäppor
snår|snår
snara|snaror
snärja|snärjor
snatterand|snatteränder
snatterandshane|snatterandshanar
snatterandshona|snatterandshonor
snickare|snickare
snigel|sniglar
snille|snillen
snilleblixt|snilleblixtar
snippa|snippor
snitt|snitt
snobb|snobbar
snöboll|snöbollar
snodd|snoddar
snödroppe|snödroppar
snödroppskaktus|snödroppskaktusar
snöfall|snöfall
snögubbe|snögubbar
snok|snokar
snökaktus|snökaktusar
snopp|snoppar
snorbuse|snorbusar
snöre|snören
snorkråka|snorkråkor
snorre|snorrar
snorunge|snorungar
snösiska|snösiskor
snöskata|snöskator
snösko|snöskor
snösparv|snösparvar
snöstorm|snöstormar
snurra|snurror
snusare|snusare
snusdosa|snusdosor
snut|snutar
snuva|snuvor
snyftreportage|snyftreportage
so|suggor
socialdemokrat|socialdemokrater
socialist|socialister
socialliberalist|socialliberalister
socialstyrelse|socialstyrelser
sociolekt|sociolekter
socken|socknar
sockerart|sockerarter
sockerbeta|sockerbetor
sockerbit|sockerbitar
sockerdricka|sockerdrickor
sockerglasyr|sockerglasyrer
sockerhalt|sockerhalter
sockerpiller|sockerpiller
sockerströare|sockerströare
sodomit|sodomiter
soffa|soffor
soffliggare|soffliggare
soffpotatis|soffpotatisar
sofism|sofismer
sojakorv|sojakorvar
sökan|sökningar
sökmotor|sökmotorer
sökning|sökningar
sökord|sökord
sökväg|sökvägar
sol|solar
solbränna|solbrännor
soldat|soldater
solfläck|solfläckar
solkatt|solkatter
solmassa|solmassor
solnedgång|solnedgångar
solo|solon
solokonsult|solokonsulter
solros|solrosor
solrosfrö|solrosfrön
solsystem|solsystem
soluppgång|soluppgångar
söm|sömmar
sommar|somrar
sommargylling|sommargyllingar
sommarkatt|sommarkatter
sommarlov|sommarlov
sommarplåga|sommarplågor
sommarsydkaktus|sommarsydkaktusar
sömnbrist|sömnbrister
sömntuta|sömntutor
son|söner
söndag|söndagar
söndagkväll|söndagkvällar
söndagmorgon|söndagmorgnar
söndagskväll|söndagskvällar
söndagsmorgon|söndagsmorgnar
söndagsseglare|söndagsseglare
sondotter|sondöttrar
sonhustru|sonhustrur
sonson|sonsöner
soppa|soppor
sopprot|sopprötter
sopran|sopraner
soptipp|soptippar
soptunna|soptunnor
sorbet|sorbeter
sorg|sorger
sorgespel|sorgespel
sorgkant|sorgkanter
sörja|sörjor
sork|sorkar
sort|sorter
sosse|sossar
sotare|sotare
sothöna|sothönor
sottärna|sottärnor
sötvatten|sötvatten
sousafon|sousafoner
souvenir|souvenirer
sovmorgon|sovmorgnar
sovrum|sovrum
sovrumsdörr|sovrumsdörrar
sovrumsfönster|sovrumsfönster
sovrumsgolv|sovrumsgolv
sovsäck|sovsäckar
spa|span
spädbarn|spädbarn
spade|spadar
spåga|spågor
spågumma|spågummor
spam|spam
spanienresa|spanienresor
spanjor|spanjorer
spanjorska|spanjorskor
spann|spann
spänn|spänn
spänning|spänningar
spänningsdelare|spänningsdelare
spanska|spanskor
spår|spår
sparbank|sparbanker
sparbössa|sparbössor
spargris|spargrisar
spark|sparkar
spärr|spärrar
sparris|sparrisar
sparrisopuntia|sparrisopuntior
sparv|sparvar
spårvagn|spårvagnar
sparvhök|sparvhökar
sparvhökshane|sparvhökshanar
sparvhökshona|sparvhökshonor
sparvuggla|sparvugglor
specialfall|specialfall
specialist|specialister
species|species
speedway|speedways
spegel|speglar
spegelkärna|spegelkärnor
spektakel|spektakel
spektralklass|spektralklasser
spel|spel
spelare|spelare
spelkonsol|spelkonsoler
spelkort|spelkort
spelöppning|spelöppningar
spelrum|spelrum
spenkaktus|spenkaktusar
spermcell|spermceller
spermie|spermier
speta|spetor
spets|spetsar
spetsbergsgås|spetsbergsgäss
spetsbergsgrissla|spetsbergsgrisslor
spett|spett
spettekaka|spettekakor
spex|spex
spiddekaga|spiddekagor
spik|spikar
spikhuvud|spikhuvuden
spillkråka|spillkråkor
spilta|spiltor
spindel|spindlar
spindelblomster|spindelblomster
spindeldjur|spindeldjur
spindelnät|spindelnät
spindelnätsdiagram|spindelnätsdiagram
spindelvårtkaktus|spindelvårtkaktusar
spira|spiror
spiral|spiraler
spiraltrappa|spiraltrappor
spis|spisar
spisfläkt|spisfläktar
spjäll|spjäll
spjut|spjut
split|split
splitter|splitter
spö|spön
spöke|spöken
spökröst|spökröster
sponsor|sponsorer
sporre|sporrar
spörsmål|spörsmål
sport|sporter
sportklubb|sportklubbar
spottloska|spottloskaor
spovsnäppa|spovsnäppor
språk|språk
språkbruk|språkbruk
språkbrukare|språkbrukare
språkforskare|språkforskare
språkkunskap|språkkunskaper
språkljud|språkljud
språkstatistik|språkstatistiker
språng|språng
språngavgift|språngavgifter
sprängladdning|sprängladdningar
sprängning|sprängningar
spraykonst|spraykonster
spricka|sprickor
spridning|spridningar
springa|springor
springare|springare
spritdryck|spritdrycker
sprits|spritsar
sprund|sprund
sprutluder|sprutluder
spya|spyor
SR-vippa|SR-vippor
sta|städer
stab|staber
ståbas|ståbasar
stack|stackar
stad|städer
städ|städ
stadga|stadgar
stadion|stadion
städning|städningar
stadsarkitekt|stadsarkitekter
stadsdel|stadsdelar
stadsförsamling|stadsförsamlingar
stadshus|stadshus
städskåp|städskåp
stadskärna|stadskärnor
stadsmiljö|stadsmiljöer
ståfela|ståfelor
staffli|stafflier
stake|stakar
staket|staket
stål|stål
stålar|stålar
stålburk|stålburkar
stalinist|stalinister
stall|stall
ställ|ställ
ställe|ställen
ställning|ställningar
ställningstagande|ställningstaganden
stam|stammar
stamfolk|stamfolk
stämma|stämmor
stammis|stammisar
stämning|stämningar
stämpel|stämplar
stämskruv|stämskruvar
stånd|stånd
standard|standarder
standardavtal|standardavtal
ståndare|ståndare
ståndpunkt|ståndpunkter
stång|stänger
stank|stanker
stänkskärm|stänkskärmar
stånna|stånnor
ståpäls|ståpälsar
stäppflyghöna|stäppflyghönor
stäpphök|stäpphökar
stäppörn|stäppörnar
stäppvipa|stäppvipor
stare|starar
starholk|starholkar
Starkeffekt|Starkeffekter
start|starter
startsida|startsidor
stat|stater
ståthållare|ståthållare
station|stationer
stationssamhälle|stationssamhälle
statist|statister
statistik|statistiker
statistiker|statistiker
stativ|stativ
statsbesök|statsbesök
statschef|statschefer
statsepizootolog|statsepizootologer
statskupp|statskupper
statskyrka|statskyrkor
statsöverhuvud|statsöverhuvuden
statsråd|statsråd
status|status
stav|stavar
stäv|stävar
stäva|stävor
stavelse|stavelser
stavning|stavningar
stavningsfel|stavningsfel
stavningsvariant|stavningsvarianter
stavrim|stavrim
stearinljus|stearinljus
steg|steg
stege|stegar
steglits|steglitsar
stegräknare|stegräknare
stek|stekar
stekare|stekare
stekpanna|stekpannor
sten|stenar
stenbär|stenbär
stenbit|stenbitar
stenbräken|stenbräknar
stenfalk|stenfalkar
stengalla|stengallor
stening|steningar
stenknäck|stenknäckar
stenplanet|stenplaneter
stenskvätta|stenskvättor
stentrast|stentrastar
stentryck|stentryck
steppsko|steppskor
sterbhus|sterbhus
stetsonkaktus|stetsonkaktusar
stick|stick
sticka|stickor
stickling|sticklingar
stift|stift
stiftelse|stiftelser
stiftpenna|stiftpennor
stig|stigar
stigman|stigmän
stil|stilar
stillahavslyra|stillahavslyror
stilleben|stilleben
stilmall|stilmallar
stim|stim
stink|stink
stipendiat|stipendiater
stirr|stirrar
stjälpa|stjälpor
stjärna|stjärnor
stjärnbild|stjärnbilder
stjärngosse|stjärngossar
stjärnkikare|stjärnkikare
stjärnpelarkaktus|stjärnpelarkaktusar
stjärnskott|stjärnskott
stjärntecken|stjärntecken
stjärt|stjärtar
stjärtand|stjärtänder
stjärtandshane|stjärtandshanar
stjärtandshona|stjärtandshonor
stjärtgosse|stjärtgossar
stjärtmes|stjärtmesar
sto|ston
stock|stockar
stockholmare|stockholmare
stockholmska|stockholmskor
stod|stoder
stöd|stöd
stol|stolar
stöld|stölder
stöldgods|stöldgods
stolle|stollar
stolpe|stolpar
stolpiller|stolpiller
stolpskott|stolpskott
stomme|stommar
stop|stop
stopp|stopp
stopptid|stopptider
stör|störar
storasyster|storasystrar
storaxel|storaxlar
stordåd|stordåd
storebror|storebröder
storebrorssamhälle|storebrorssamhällen
storhet|storheter
stork|storkar
storkfjäder|storkfjädrar
storkök|storkök
storlabb|storlabbar
storlek|storlekar
storlom|storlommar
storm|stormar
stormfågel|stormfåglar
stormkök|stormkök
stormsvala|stormsvalor
störning|störningar
storpack|storpack
storsatsning|storsatsningar
storsik|storsikar
storskallesik|storskallesikar
storskarv|storskarvar
storskrake|storskrakar
storslalomskida|storslalomskidor
storspov|storspovar
storstad|storstäder
storstädning|storstädningar
stortå|stortår
stortånagel|stortånaglar
störtloppsskida|störtloppsskidor
stortrapp|stortrappar
story|stories
stöt|stötar
stötta|stöttor
stövel|stövlar
stövlett|stövletter
strå|strån
sträcka|sträckor
sträckbänk|sträckbänkar
straff|straff
straffspark|straffsparkar
stråkinstrument|stråkinstrument
strålben|strålben
stråle|strålar
strålvårtkaktus|strålvårtkaktusar
strand|stränder
strandmaskros|strandmaskrosor
strandskata|strandskator
stränginstrument|stränginstrument
strateg|strateger
strategi|strategier
stratosfär|stratosfärer
streber|strebrar
streck|streck
streckgubbe|streckgubbar
strejk|strejker
strid|strider
stridsvagn|stridsvagnar
stridsyxa|stridsyxor
stridszon|stridszoner
strimla|strimlor
strimma|strimmor
string|stringar
stripa|stripor
stripp|strippar
strippa|strippor
ström|strömmar
strömand|strömänder
strömandshane|strömandshanar
strömandshona|strömandshonor
strömavbrott|strömavbrott
strömbrytare|strömbrytare
strömfåra|strömfåror
strömming|strömmingar
strömstare|strömstarar
struktur|strukturer
strumpa|strumpor
strupe|strupar
strut|strutar
struts|strutsar
strutsägg|strutsägg
struva|struvor
strykare|strykare
strykjärn|strykjärn
stubbholk|stubbholkar
stubbstjärtseglare|stubbstjärtseglare
stubin|stubiner
student|studenter
studentrabatt|studentrabatter
studerande|studerande
studieresultat|studieresultat
studiestöd|studiestöd
studium|studier
studsboll|studsbollar
stuga|stugor
stumfilm|stumfilmer
stump|stumps
stund|stunder
stup|stup
stut|stutar
stycke|stycken
styckebruk|styckebruk
styckeindelning|styckeindelningar
styggelse|styggelser
stygging|styggingar
styltlöpare|styltlöpare
styltsnäppa|styltsnäppor
styrelsemöte|styrelsemöten
styrelseordförande|styrelseordförande
styrelseproffs|styrelseproffs
styrka|styrkor
styrkedemonstration|styrkedemonstrationer
subba|subbor
subjekt|subjekt
subjektsform|subjektsformer
substans|substanser
substantiv|substantiv
substantivering|substantiveringar
substantivform|substantivformer
substitut|substitut
substitution|substitutioner
subtraktion|subtraktioner
succé|succéer
suck|suckar
suckat|suckater
suckulent|suckulenter
sudd|sudd
suddgummi|suddgummin
suddi|?
suddigum|suddigum
sudoku|sudokun
suffix|suffix
sufflör|sufflörer
sugga|suggor
sugrör|sugrör
suicid|suicidier
sulfid|sulfider
summa|summor
summatecken|summatecken
sumprunkare|sumprunkare
sumpvipa|sumpvipor
sunnimuslim|sunnimuslimer
sunnit|sunniter
sup|supar
superdator|superdatorer
superellips|superellipser
superhjälte|superhjältar
superlativ|superlativer
superlativform|superlativformer
supernova|supernovor
superoxid|superoxider
superposition|superpositioner
supinumform|supinumformer
suppleant|suppleanter
supplementvinkel|supplementvinklar
sura|suror
surdeg|surdegar
surdegsbröd|surdegsbröd
surf|surfs
surr|surr
surrogat|surrogat
surrogatmamma|surrogatmammor
sus|Nominativ
susceptans|susceptanser
susning|susningar
suspension|suspensioner
suspensoar|suspensoarer
suterränghus|suterränghus
svacka|svackor
svåger|svågrar
svägerska|svägerskor
svala|svalor
svalg|svalg
svamp|svampar
svampart|svamparter
svampkorg|svampkorgar
svampsås|svampsåser
svan|svanar
svanfjäder|svanfjädrar
svängdörr|svängdörrar
svängning|svängningar
svängningstid|svängningstider
svångrem|svångremmar
svans|svansar
svar|svar
svärd|svärd
svärdotter|svärdöttrar
svärfar|svärfäder
svärförälder|svärföräldrar
svårighet|svårigheter
svärmeri|svärmerier
svärmor|svärmödrar
svärmorskudde|svärmorskuddar
svärord|svärord
svärson|svärsöner
svärta|svärtor
svartabörshaj|svartabörshajar
svartabörspris|svartabörspriser
svartand|svartänder
svartfot|svartfötter
svarthakedopping|svarthakedoppingar
svarting|svartingar
svartlärka|svartlärkor
svartmes|svartmesar
svartsnäppa|svartsnäppor
svarttärna|svarttärnor
svartvinbärsgelé|svartvinbärsgeléer
svartvinbärskräm|svartvinbärskrämer
svartvinbärsmarmelad|svartvinbärsmarmelader
svartvinbärssaft|svartvinbärssafter
svastika|svastikor
svävare|svävare
svävning|svävningar
svek|svek
svekoman|svekomaner
sven|svenner
svenne|svennar
svensexa|svensexor
svenska|svenskor
svensklärare|svensklärare
svepelektronmikroskop|svepelektronmikroskop
svettning|svettningar
svin|svin
svindleri|svindlerier
svinn|svinn
svinotta|svinottor
svit|sviter
sviter|sviter
svordom|svordomar
switch|switchar
sydkaktus|sydkaktusar
sydkorean|sydkoreaner
sydkoreanska|sydkoreanskor
sydnäktergal|sydnäktergalar
syfokant|syfokanter
syfte|syften
sylopuntia|sylopuntior
sylt|sylter
sylta|syltor
symbol|symboler
symfoni|symfonier
symmetriaxel|symmetriaxlar
sympati|sympatier
symptom|symptom
symtom|symtom
syn|syner
synagoga|synagogor
synd|synder
syndabock|syndabockar
syndikat|syndikat
synförmåga|synförmågor
synintryck|synintryck
synkop|synkoper
synnedsättning|synnedsättningar
synnerv|synnerver
synonymordbok|synonymordböcker
synopsis|synopsisar
synorgan|synorgan
synpunkt|synpunkter
synsätt|synsätt
synt|syntar
syntes|synteser
synthesizer|synthesizer
synundersökning|synundersökningar
synvilla|synvillor
synvinkel|synvinklar
syra|syror
syra-baspar|syra-baspar
syre|syren
syrra|syrror
syskon|syskon
syskonprojekt|syskonprojekt
syskonsjöborrekaktus|syskonsjöborrekaktusar
syskonskara|syskonskaror
syskonvårtkaktus|syskonvårtkaktusar
syslöjdsfröken|syslöjdsfröknar
sysop|sysopar
sysselsättning|sysselsättningar
syssla|sysslor
syssling|sysslingar
system|system
systemkamera|systemkameror
systemkrav|systemkrav
syster|systrar
systerdotter|systerdöttrar
systerskap|systerskap
systerson|systersöner
tå|tår
tabbe|tabbar
tabell|tabeller
tablå|tablåer
tablett|tabletter
tabu|tabun
tachyon|tachyoner
tack|tack
tacka|tackor
täcke|täcken
tafofobi|tafofobier
tag|tags
tåg|tåg
tågbiljett|tågbiljetter
tågförare|tågförare
tagg|taggar
taggmoln|taggmoln
taggstjärtseglare|taggstjärtseglare
taggtrådsvårtkaktus|taggtrådsvårtkaktusar
tågresa|tågresor
tågtidtabell|tågtidtabeller
tågtoalett|tågtoaletter
tågurspårning|tågurspårningar
taigaflugsnappare|taigaflugsnappare
taigatrast|taigatrastar
taikonaut|taikonauter
tak|tak
tåke|tåker
taklampa|taklampor
taklist|taklister
taklöksklotkaktus|taklöksklotkaktusar
takt|takter
taktik|taktiker
taktiker|taktiker
tal|tal
tålamod|tålamod
talang|talanger
talar|talarer
talare|talare
talarestol|talarestolar
talarstol|talarstolar
talbas|talbaser
talesätt|talesätter
talföljd|talföljder
talgoxe|talgoxar
talja|taljor
täljare|täljare
Täljetok|Täljetokar
tall|tallar
tallbit|tallbitar
tallinje|tallinjer
tallkottskaktus|tallkottskaktusar
tallrik|tallrikar
tallskog|tallskogar
tallsparv|tallsparvar
talltita|talltitor
talong|talonger
tält|tält
tältduk|tältdukar
tältpinne|tältpinnar
taltrast|taltrastar
tamburinist|tamburinister
tamil|tamiler
tamkatt|tamkatter
tamråtta|tamråttor
tamul|tamuler
tånagel|tånaglar
tand|tänder
tändare|tändare
tandborste|tandborstar
tanddoktor|tanddoktorer
tandemcykel|tandemcyklar
tandhygienist|tandhygienister
tandkött|tandkött
tandkräm|tandkrämer
tandkrämsfläck|tandkrämsfläckar
tandkrämstub|tandkrämstuber
tandkrona|tandkronor
tandläkare|tandläkare
tandpetare|tandpetare
tändsticka|tändstickor
tändsticksask|tändsticksaskar
tång|tänger
tangent|tangenter
tangentbord|tangentbord
tangorabatt|tangorabatter
tank|tankar
tänk|tänk
tanke|tankar
tankeexperiment|tankeexperiment
tankenöt|tankenötter
tänkesätt|tänkesätt
tant|tanter
tapa|tapor
tapas|tapas
tapasbar|tapasbarer
tape|taper
tapet|tapeter
tapetserare|tapetserare
tapp|tappar
tappsjöborrekaktus|tappsjöborrekaktusar
tappstation|tappstationer
tår|tårar
tärna|tärnor
tärning|tärningar
tärnmås|tärnmåsar
tars|tarser
tårta|tårtor
task|taskar
taskmört|taskmörtar
tåsko|tåskor
tass|tassar
tatarfalk|tatarfalkar
tätort|tätorter
tätting|tättingar
tatuering|tatueringar
tauon|tauoner
tautologi|tautologier
tavelram|tavelramar
tavla|tavlor
tävling|tävlingar
tax|taxar
taxa|taxor
taxameter|taxametrar
taxi|taxibilar
taxvalp|taxvalpar
Taylorserie|Taylorserier
te|teer
team|team
teater|teatrar
teblad|teblad
tecken|tecken
teckenstudium|teckenstudier
teckning|teckningar
tee|tees
tegel|tegel
tegelkranskaktus|tegelkranskaktusar
teism|teismer
teist|teister
tejp|tejper
tekaka|tekakor
tekniker|tekniker
teknofobi|teknofobier
tekopp|tekoppar
telefax|telefaxar
telefon|telefoner
telefonavlyssning|telefonavlyssningar
telefonförbindelse|telefonförbindelser
telefonförsäljare|telefonförsäljare
telefonkatalog|telefonkataloger
telefonnummer|telefonnummer
telefonsamtal|telefonsamtal
telegrafhatt|telegrafhattar
telegrafnyckel|telegrafnycklar
telegram|telegram
teleskop|teleskop
teleskopord|teleskopord
television|televisioner
televisionsapparat|televisionsapparater
tema|teman
tempel|tempel
temperament|temperament
temperatur|temperaturer
temugg|temuggar
tendens|tendenser
tendu|tenduer
tennisboll|tennisbollar
tennsoldat|tennsoldater
tenor|tenorer
tenta|tentor
tentakel|tentakler
tentamen|tentamina
tentamensvakt|tentamensvakter
tentand|tentander
tentavakt|tentavakter
teolog|teologer
teorem|teorem
teori|teorier
terapeut|terapeuter
terapi|terapier
tereksnäppa|tereksnäppor
term|termer
terminologi|terminologier
termit|termiter
termometer|termometrar
termos|termosar
termosfär|termosfärer
terrängmotorfordon|terrängmotorfordon
terrasspunkt|terrasspunkter
territorium|territorier
terrorattack|terrorattacker
terrorattentat|terrorattentat
terrordåd|terrordåd
terrorhot|terrorhot
terrorist|terrorister
tes|teser
tesaurus|tesaurusar
tesil|tesilar
tesked|teskedar
teskedsmått|teskedsmått
test|test
testamente|testamenten
testikel|testiklar
testmatch|testmatcher
testresultat|testresultat
tetraeder|tetraedrar
tetraflexagon|tetraflexagoner
tetragon|tetragoner
tetralogi|tetralogier
teveapparat|teveapparater
teveronika|teveronikor
text|texter
textbok|textböcker
textfil|textfiler
textförfattare|textförfattare
texthäfte|texthäften
textil|textiler
textmeddelande|textmeddelanden
textsamling|textsamlingar
thailändare|thailändare
thailändska|thailändskor
thanatofobi|thanatofobier
theremin|thereminer
tibetan|tibetaner
tibetanska|tibetanskor
tick|tick
ticka|tickor
tid|tider
tidevarv|tidevarv
tidmätning|tidmätningar
tidning|tidningar
tidningsord|tidningsord
tidpunkt|tidpunkter
tidsdilatation|tidsdilatationer
tidskrift|tidskrifter
tidslinje|tidslinjer
tidsoptimist|tidsoptimister
tidsperiod|tidsperioder
tidsplan|tidsplaner
tidsresa|tidsresor
tidsschema|tidsscheman
tidtabell|tidtabeller
tidtagning|tidtagningar
tidvattenkraft|tidvattenkrafter
tiger|tigrar
tik|tikar
tilde|tilden
tilja|tiljor
tillägg|tillägg
tillämpning|tillämpningar
tillåtelse|tillåtelser
tillbringare|tillbringare
tilldragelse|tilldragelser
tillfälle|tillfällen
tillfällighet|tillfälligheter
tillfredsställelse|tillfredsställelser
tillfrisknande|tillfrisknanden
tillgång|tillgångar
tillhandaflicka|tillhandaflickor
tillhörighet|tillhörigheter
tillmäle|tillmälen
tillsägelse|tillsägelser
tillskott|tillskott
tillstånd|tillstånd
tilltalad|tilltalade
tilltalsnamn|tilltalsnamn
tilltalsord|tilltalsord
tillverkare|tillverkare
tillverkning|tillverkningar
tillverkningsindustri|tillverkningsindustrier
tillverkningsland|tillverkningsländer
timma|timmar
timme|timmar
timmer|timmer
timmerråvara|timmerråvaror
timvisare|timvisare
ting|ting
tingest|tingestar
tingsrätt|tingsrätter
tingsställe|tingsställen
tiohörning|tiohörningar
tiokrona|tiokronor
tiokronorssedel|tiokronorssedlar
tiol|tioler
tiondedel|tiondedelar
tiondel|tiondelar
tiotal|tiotal
tiotusenkronorssedel|tiotusenkronorssedlar
tips|tips
tirad|tirader
tisdag|tisdagar
tisdagkväll|tisdagkvällar
tisdagmorgon|tisdagmorgnar
tisdagskväll|tisdagskvällar
tisdagsmorgon|tisdagsmorgnar
titan|titaner
Titan|Titanen
titel|titlar
tittare|tittare
tjabo|tjabor
tjack|tjack
tjäder|tjädrar
tjallare|tjallare
tjällossning|tjällossningar
tjänare|tjänare
tjänst|tjänster
tjänsteman|tjänstemän
tjära|tjäror
tjärn|tjärnar
tjat|tjat
tjeck|tjecker
tjej|tjejer
tjetjenier|tjetjenier
tjetjenska|tjetjenskor
tjockfot|tjockfotar
tjockis|tjockisar
tjockskärm|tjockskärmar
tjog|tjog
tjomme|tjommar
tjottablängare|tjottablängare
tjuga|tjugor
tjugokronorssedel|tjugokronorssedlar
tjugolapp|tjugolappar
tjugondedel|tjugondedelar
tjugondel|tjugondelar
tjur|tjurar
tjurfäktning|tjurfäktningar
tjuv|tjuvar
tjuvsena|tjuvsenor
tjuvtittare|tjuvtittare
tjyv|tjyvar
toa|toor
toalett|toaletter
toalettbesök|toalettbesök
toalettborste|toalettborstar
toalettsits|toalettsitsar
toalettstol|toalettstolar
toasits|toasitsar
tobisgrissla|tobisgrisslor
tock|tockar
toffel|tofflor
toffelhjälte|toffelhjältar
toffla|tofflor
tofflare|tofflare
tofs|tofsar
tofskaktus|tofskaktusar
tofslärka|tofslärkor
tofslunne|tofslunnar
tofsmes|tofsmesar
tofssydkaktus|tofssydkaktusar
tofsvipa|tofsvipor
toga|togor
tok|tokar
tokelauer|tokelauer
tokfrans|tokfransar
tokmatt|tokmattar
tolerans|toleranser
tolftedel|tolftedelar
tolk|tolkar
tolkning|tolkningar
tölp|tölpar
töm|tömmar
tomat|tomater
tomatmarmelad|tomatmarmelader
tomatpuré|tomatpuréer
tomatsås|tomatsåser
tomatsoppa|tomatsoppor
tomhet|tomheter
tomt|tomter
tomte|tomtar
ton|ton
tonåring|tonåringar
toning|toningar
tönt|töntar
topolog|topologer
toponym|toponymer
topp|toppar
toppkvark|toppkvarkar
toppmöte|toppmöten
toppskarv|toppskarvar
tordmule|tordmular
tordön|tordön
torg|torg
torka|torkor
torkolla|torkollor
torn|torn
törnekrona|törnekronor
tornfalk|tornfalkar
tornkvarn|tornkvarnar
tornseglare|tornseglare
törnskata|törnskator
tornuggla|tornugglor
torp|torp
torped|torpeder
torsdag|torsdagar
torsdagkväll|torsdagkvällar
torsdagmorgon|torsdagmorgnar
torsdagskväll|torsdagskvällar
torsdagsmorgon|torsdagsmorgnar
torsk|torskar
torsmånad|torsmånader
törst|törster
torus|torusar
tos|tosar
tös|töser
totalmatris|totalmatriser
touchpanel|touchpaneler
toxin|toxiner
trä|2
träblåsinstrument|träblåsinstrument
tråd|trådar
träd|träd
trädgård|trädgårdar
trädgårdsbord|trädgårdsbord
trädgårdsmästare|trädgårdsmästare
trädgårdsmöbel|trädgårdsmöbler
trädgårdsredskap|trädgårdsredskap
trädgårdssångare|trädgårdssångare
trädgårdsträdkrypare|trädgårdsträdkrypare
tradition|traditioner
trädkaktus|trädkaktusar
trädkrypare|trädkrypare
trädlärka|trädlärkor
trädmås|trädmåsar
trädopuntia|trädopuntior
trädpiplärka|trädpiplärkor
trädstam|trädstammar
träff|träffar
trafikant|trafikanter
trafikfara|trafikfaror
trafikproblem|trafikproblem
trafikstockning|trafikstockningar
tragedi|tragedier
trailer|trailrar
trakt|trakter
traktat|traktater
traktor|traktorer
traktör|traktörer
träl|trälar
trall|trallar
tramp|trampar
trampa|trampor
trampcykel|trampcyklar
tramsa|tramsor
trana|tranor
tränare|tränare
tranbär|tranbär
tranbärssaft|tranbärssafter
trångsynthet|trångsyntheter
träning|träningar
träningslokal|träningslokaler
transa|transor
transaktion|transaktioner
transformation|transformationer
transformator|transformatorer
transistor|transistorer
transistorradio|transistorradior
transition|transitioner
transkription|transkriptioner
translation|translationer
transmissionselektronmikroskop|transmissionselektronmikroskop
transofil|transofiler
transperson|transpersoner
transponat|transponater
transport|transporter
transportmedel|transportmedel
trapets|trapetser
trapp|trapper
trappa|trappor
trappavsats|trappavsatser
trappsteg|trappsteg
trasa|trasor
trasdocka|trasdockor
trashank|trashankar
träslag|träslag
trassel|trassel
trassent|trassenter
trast|trastar
trastfågel|trastfåglar
tratt|trattar
trattis|trattisar
trattkantarell|trattkantareller
trattsjöborrekaktus|trattsjöborrekaktusar
trauma|trauman
travalj|travaljer
trea|treor
tredjedel|tredjedelar
tredjederivata|tredjederivator
tredjegradsekvation|tredjegradsekvationer
tredjegradsfunktion|tredjegradsfunktioner
tredjegradspolynom|tredjegradspolynom
trehjuling|trehjulingar
trehörning|trehörningar
trekant|trekanter
tremänning|tremänningar
trend|trender
trendsättare|trendsättare
tretal|tretal
tretår|tretårar
trettondag|trettondagar
trettondagsafton|trettondagsaftnar
trettondedel|trettondedelar
trettondel|trettondelar
triangel|trianglar
tribun|tribuner
tribut|tributer
trick|trick
trilling|trillingar
trilogi|trilogier
trimmer|trimmrar
trio|trior
triod|trioder
tripp|tripper
trippelbindning|trippelbindningar
trippelbonde|trippelbönder
trippeldäckare|trippeldäckare
trippelintegral|trippelintegraler
trippelstjärna|trippelstjärnor
triskaidekafobi|triskaidekafobier
trissa|trissor
triumf|triumfer
triumvirat|triumvirat
trivialnamn|trivialnamn
trofé|troféer
tröghetssystem|tröghetssystem
tröja|tröjor
trojan|trojaner
troll|troll
trollkäring|trollkäringar
trollkarl|trollkarlar
tromb|tromber
trombocyt|trombocyter
trombon|tromboner
tron|troner
tropik|tropiker
troponym|troponymer
troposfär|troposfärer
trosa|trosor
tröskel|trösklar
tröstpris|tröstpriser
trots|–
trottoar|trottoarer
truckflata|truckflator
trudelutt|trudelutter
truism|truismer
trumma|trummor
trummis|trummisar
trumpet|trumpeter
trumslagare|trumslagare
trunk|trunkar
trupp|trupper
trust|truster
trut|trutar
tryck|tryck
tryckeri|tryckerier
trygghet|tryggheter
trygghetskänsla|trygghetskänslor
tryne|trynen
tsar|tsarer
tsunami|tsunamier
tub|tuber
tuba|tubor
tubaist|tubaister
tugga|tuggor
tuggummi|tuggummin
tui|tuis
tuja|tujor
tulipanaros|tulipanarosor
tull|tullar
tullare|tullare
tum|tum
tumme|tummar
tumnagel|tumnaglar
tumör|tumörer
tumstockskaktus|tumstockskaktusar
tumult|tumult
tun|tun
tundrapiplärka|tundrapiplärkor
tundrasnäppa|tundrasnäppor
tunga|tungor
tungel|tungel
tungomål|tungomål
tunna|tunnor
tunnelbana|tunnelbanor
tupel|tuplar
tupp|tuppar
tupplur|tupplurar
tur|turer
turban|turbaner
turist|turister
turk|turkar
turkduva|turkduvor
turkiska|turkiskor
turné|turnéer
turnering|turneringar
turturduva|turturduvor
tusenkonstnär|tusenkonstnärer
tusenkronorssedel|tusenkronorssedlar
tusenlapp|tusenlappar
tusental|tusental
tuvaluan|tuvaluaner
tuvaluanska|tuvaluanskor
tuvkaktus|tuvkaktusar
tuvklotkaktus|tuvklotkaktusar
tuvopuntia|tuvopuntior
tuvsnäppa|tuvsnäppor
tv-apparat|tv-apparater
TV-apparat|TV-apparater
TV-bolag|TV-bolagen
TV-kort|TV-kort
TV-program|TV-program
tv-serie|tv-serier
TV-skärm|TV-skärmar
tv-spel|tv-spel
TV-studio|TV-studior
tvåa|tvåor
tvåfrontskrig|tvåfrontskrig
tvaga|tvagor
tvåhjuling|tvåhjulingar
tvål|tvålar
tvång|tvång
tvärflöjt|tvärflöjter
tvåstavighetsaccent|tvåstavighetsaccenter
tvåtal|tvåtal
tvättbräda|tvättbrädor
tvättmaskin|tvättmaskiner
tvättstuga|tvättstugor
tvegifte|tvegiften
tvesovlare|tvesovlare
tvilling|tvillingar
tving|tvingar
tvivel|tvivel
tyfon|tyfoner
tygeltärna|tygeltärnor
tyngd|tyngder
tyngdacceleration|tyngdaccelerationer
typ|typer
typvärde|typvärden
tyranni|tyrannier
tyrolare|tyrolare
tyska|tyskor
tysklärare|tysklärare
tystnad|tystnader
ubåt|ubåtar
udd|uddar
uddamålsseger|uddamålssegrar
udde|uddar
uf|ufvar
ufo|ufon
uggla|ugglor
ugglefjäder|ugglefjädrar
uggleholk|uggleholkar
ugglemånad|ugglemånader
ugn|ugnar
ukrainska|ukrainskor
ukulele|ukuleler
ulf|ulfvar
ullbärskaktus|ullbärskaktusar
ullkaktus|ullkaktusar
ullstjärnkaktus|ullstjärnkaktusar
ullsydkaktus|ullsydkaktusar
ulltrattkaktus|ulltrattkaktusar
ullvårtkaktus|ullvårtkaktusar
ulster|ulstrar
ultimatum|ultimatum
ultracentrifug|ultracentrifuger
ultracentrifugering|ultracentrifugeringar
ultraljud|ultraljud
ulv|ulvar
undantag|undantag
under|under
underbyxa|underbyxor
underfamilj|underfamiljer
undergrupp|undergrupper
underhåll|underhåll
underhållning|underhållningar
underrubrik|underrubriker
underskrift|underskrifter
undersökning|undersökningar
undervisning|undervisningar
undfägnad|undfägnader
undulat|undulater
ungdom|ungdomar
ungdomsrabatt|ungdomsrabatter
unge|ungar
ungerska|ungerskor
ungfågel|ungfåglar
ungkarl|ungkarlar
ungrare|ungrare
union|unioner
unionsterritorium|unionsterritorier
unitarie|unitarier
universalgeni|universalgenier
universitet|universitet
universitetslektor|universitetslektorer
uns|uns
uppbåd|uppbåd
uppdatering|uppdateringar
uppdrag|uppdrag
uppehållstillstånd|uppehållstillstånd
uppfattning|uppfattningar
uppfinnare|uppfinnare
uppfinning|uppfinningar
uppförande|uppföranden
uppgift|uppgifter
uppgörelse|uppgörelser
upphov|upphov
uppkvark|uppkvarkar
uppladdning|uppladdningar
upplaga|upplagor
uppläggning|uppläggningar
upplopp|upplopp
upplösning|upplösningar
upplysning|upplysningar
upprinnelse|upprinnelser
uppror|uppror
uppsägelse|uppsägelser
uppsägning|uppsägningar
uppsåt|uppsåt
uppsats|uppsatser
uppsättning|uppsättningar
uppskov|uppskov
uppslag|uppslag
uppslagsbok|uppslagsböcker
uppslagsord|uppslagsord
uppslagsverk|uppslagsverk
uppsving|uppsving
upptäckare|upptäckare
upptäckt|upptäckter
upptäcktsresa|upptäcktsresor
upptäcktsresande|upptäcktsresande
upptågsmakare|upptågsmakare
uppvärmning|uppvärmningar
ur|ur
urbild|urbilder
urindoeuropeiska|urindoeuropeiskor
urklipp|urklipp
urpremiär|urpremiärer
ursäkt|ursäkter
urskog|urskogar
urspårning|urspårningar
ursprung|ursprung
urtavla|urtavlor
uruppförande|uruppföranden
urval|urval
urverk|urverk
USB-minne|USB-minnen
usling|uslingar
usurpator|usurpatorer
utbildning|utbildningar
utbud|utbud
utedass|utedass
uteliggare|uteliggare
utemöbel|utemöbler
uteplats|uteplatser
utfall|utfall
utförande|utföranden
utfrågning|utfrågningar
utgåva|utgåvor
utgift|utgifter
utkast|utkast
utlandsadoption|utlandsadoptioner
utlandssvensk|utlandssvenskar
utlänning|utlänningar
utlåtande|utlåtanden
utlösning|utlösningar
utomjording|utomjordingar
utomkvedskap|utomkvedskap
utopi|utopier
utredare|utredare
utrikesminister|utrikesministrar
utropstecken|utropstecken
utrum|utrer
utsaga|utsagor
utseende|utseenden
utsikt|utsikter
utskällning|utskällningar
utskrift|utskrifter
utslag|utslag
utsmyckning|utsmyckningar
utspel|utspel
utställning|utställningar
utsvävning|utsvävningar
uttagsautomat|uttagsautomater
uttal|uttal
utter|uttrar
uttryck|uttryck
uv|uvar
uvertyr|uvertyrer
uzbek|uzbeker
uzbekiska|uzbekiskor
väbel|väblar
väckarklocka|väckarklockor
väckning|väckningar
vad|vad
våd|våder
vadben|vadben
vaddkaktus|vaddkaktusar
väderkvarn|väderkvarnar
väf|väfvar
våffla|våfflor
våg|vågor
väg|vägar
vägarbete|vägarbeten
vägg|väggar
vagina|vaginor
väglag|väglag
våglängd|våglängder
vägledning|vägledningar
vagn|vagnar
vagnslider|vagnslider
vågrörelse|vågrörelser
vägskäl|vägskäl
vägskylt|vägskyltar
vågtal|vågtal
vak|vakar
vaka|vakor
vakans|vakanser
vakt|vakter
vaktel|vaktlar
vaktis|vaktisar
vaktmästare|vaktmästare
vakuum|vakuum
val|valar
valack|valacker
valberedning|valberedningar
våld|våld
välde|välden
våldgästning|våldgästningar
våldtäkt|våldtäkter
våldtäktsman|våldtäktsmän
valens|valenser
valfrihet|valfriheter
väljare|väljare
valkampanj|valkampanjer
valkungadöme|valkungadömen
valkyria|valkyrior
valla|vallor
vallgrav|vallgravar
välling|vällingar
vallmo|vallmor
vallon|valloner
vallonska|vallonskor
välmående|välmåenden
valör|valörer
valp|valpar
valresultat|valresultat
valross|valrossar
vals|valser
valsning|valsningar
valthorn|valthorn
valuta|valutor
valutaunion|valutaunioner
valv|valv
valvaka|valvakor
vampyr|vampyrer
vampyrfladdermus|vampyrfladdermöss
vän|vänner
vana|vanor
vånda|våndor
vända|vändor
vandal|vandaler
vändkrets|vändkretsar
vändpunkt|vändpunkter
vandringstrast|vandringstrastar
våning|våningar
våningscylinderkaktus|våningscylinderkaktusar
våningshus|våningshus
våningssäng|våningssängar
väninna|väninnor
vänskap|vänskaper
vänsterled|vänsterled
vante|vantar
väntedrag|väntedrag
väntetid|väntetider
vapen|vapen
vapenövning|vapenövningar
väpnarkaktus|väpnarkaktusar
vara|varor
varan|varaner
värd|värdar
varda|vardar
vardag|vardagar
vårdagjämning|vårdagjämningar
vardagsrum|vardagsrum
vardagsrumsgolv|vardagsrumsgolv
vårdcentral|vårdcentraler
värddator|värddatorer
värde|värden
värdemängd|värdemängder
värdeminskning|värdeminskningar
värdering|värderingar
varelse|varelser
varf|varf
varfågel|varfåglar
varg|vargar
varginna|varginnor
vargpäls|vargpälsar
variant|varianter
variation|variationer
värk|värkar
värld|världar
världsallt|världsallt
världsarv|världsarv
världsåskådning|världsåskådningar
världsaxel|världsaxlar
världsbild|världsbilder
världsdel|världsdelar
världshav|världshav
världskrig|världskrig
världsmästare|världsmästare
världsmästerskap|världsmästerskap
världsrekord|världsrekord
varmkorv|varmkorvar
värmländska|värmländskor
värmlänning|värmlänningar
varmvattenkran|varmvattenkranar
värn|värn
varning|varningar
värnpliktsvägrare|värnpliktsvägrare
varseblivningspsykologi|varseblivningspsykologier
varsel|varsel
vårsiklöja|vårsiklöjor
vårstädning|vårstädningar
vårtkaktus|vårtkaktusar
vårtsjöborrekaktus|vårtsjöborrekaktusar
varubud|varubud
varuhus|varuhus
varulf|varulfvar
varulv|varulvar
varumärke|varumärken
varv|varv
vas|vaser
vasall|vasaller
väsen|väsen
väska|väskor
vassångare|vassångare
vasspipa|vasspipor
väst|västar
västgöte|västgötar
västkust|västkustar
västsaharier|västsaharier
väteatom|väteatomer
vätejon|vätejoner
våtmark|våtmarker
våtmarksart|våtmarksarter
vätska|vätskor
vatten|vatten
vattendelare|vattendelare
vattendrag|vattendrag
vattenfall|vattenfall
vattenfläck|vattenfläckar
vattenflaska|vattenflaskor
vattenförorening|vattenföroreningar
vattenglas|vattenglas
vattenhink|vattenhinkar
vattenkanna|vattenkannor
vattenkokare|vattenkokare
vattenkraftverk|vattenkraftverk
vattenkran|vattenkranar
vattenkrig|vattenkrig
vattenmelon|vattenmeloner
vattenpiplärka|vattenpiplärkor
vattenpistol|vattenpistoler
vattenpöl|vattenpölar
vattenpuss|vattenpussar
vattenrall|vattenrallar
vattenrör|vattenrör
vattenskada|vattenskador
vattenslang|vattenslangar
vattenspridare|vattenspridare
vattenstänk|vattenstänk
vattenyta|vattenytor
vattkoppor|vattkoppor
väv|vävar
vävnad|vävnader
vax|vaxer
växel|växlar
växelström|växelströmmar
växt|växter
växtart|växtarter
växtätare|växtätare
växtfamilj|växtfamiljer
växthus|växthus
växthuseffekt|växthuseffekter
växtlighet|växtligheter
veck|veck
vecka|veckor
veckodag|veckodagar
veckoslut|veckoslut
vedergällning|vedergällningar
vedugn|vedugnar
vedugnspizza|vedugnspizzor
vegan|veganer
vegetarian|vegetarianer
vegetarianska|vegetarianskor
vegetation|vegetationer
vektor|vektorer
vektorfält|vektorfält
vektorprodukt|vektorprodukter
vektorrum|vektorrum
velociped|velocipeder
ven|vener
vendetta|vendettor
veneration|venerations
ventilbasun|ventilbasuner
veranda|verandor
verb|verb
verbform|verbformer
verbgenus|verbgenus
verbning|verbningar
verifikation|verifikationer
verk|verk
verkan|verkningar
verklighet|verkligheter
verkningsgrad|verkningsgrader
verksamhet|verksamheter
verkställighetsförordnande|verkställighetsförordnanden
verktyg|verktyg
verktygslåda|verktygslådor
verld|verldar
vers|verser
versal|versaler
version|versioner
vete|veten
vetenskap|vetenskaper
vetenskapsman|vetenskapsmän
veteran|veteraner
veterinär|veterinärer
veto|veton
vetorätt|vetorätter
vevstake|vevstakar
vi|–
viadukt|viadukter
vibb|vibbar
vibrafon|vibrafoner
vickning|vickningar
vidd|vidder
video|videor
videokamera|videokameror
videsparv|videsparvar
vietnames|vietnameser
vietnamesiska|vietnamesiskor
vigg|viggar
vigghane|vigghanar
vigghona|vigghonor
vigsel|vigslar
vigt|vigter
vik|vikar
vikariat|vikariat
vikarie|vikarier
viking|vikingar
vikningseffekt|vikningseffekter
viktklass|viktklasser
viktualie|viktualier
vila|vilor
vilddjur|vilddjur
vildsvin|vildsvin
vilja|viljor
villa|villor
villasamhälle|villasamhällen
villebråd|villebråd
villkor|villkor
vin|viner
vinbärsgelé|vinbärsgeléer
vinbärskräm|vinbärskrämer
vinbärssaft|vinbärssafter
vinbutelj|vinbuteljer
vind|vindar
vinda|vindor
vindil|vindilar
vindkraftverk|vindkraftverk
vindmölla|vindmöllor
vindöga|vindögon
vindriktning|vindriktningar
vindruta|vindrutor
vindrutetorkare|vindrutetorkare
vindruva|vindruvor
vindskydd|vindskydd
vinflaska|vinflaskor
vinge|vingar
vinglas|vinglas
vingspets|vingspetsar
vink|vinkar
vinkel|vinklar
vinkelhastighet|vinkelhastigheter
vinnare|vinnare
vinpava|vinpavor
vinst|vinster
vinter|vintrar
vintergrad|vintergrader
vinterhämpling|vinterhämplingar
vinterkaktus|vinterkaktusar
vinterledighet|vinterledigheter
vinterlov|vinterlov
vintermånad|vintermånader
viola|violor
violin|violiner
violinist|violinister
violsjöborrekaktus|violsjöborrekaktusar
vippa|vippor
vireo|vireor
virtuositet|virtuositeter
virus|virus
visa|visor
visdom|visdomar
visdomsord|visdomsord
vishet|visheter
vision|visioner
visit|visiter
visp|vispar
visselpipa|visselpipor
vissla|visslor
vita|vitor
vitamin|vitaminer
vite|viten
vitgumpsnäppa|vitgumpsnäppor
vitling|vitlingar
vitlök|vitlökar
vitryska|vitryskor
vitryss|vitryssar
vits|vitsar
vitsippa|vitsippor
vittne|vittnen
vittra|vittror
vittrut|vittrutar
vitvinbärssaft|vitvinbärssafter
viv|viv
VM|VM
VM-brons|VM-brons
VM-guld|VM-guld
VM-medalj|VM-medaljer
VM-silver|VM-silver
vokabulär|vokabulärer
vokal|vokaler
vokativ|vokativer
volontär|volontärer
voltstart|voltstarter
volym|volymer
vortex|vortex
vovve|vovvar
voyeur|voyeurer
vrå|vrår
vrak|vrak
vrål|vrål
vulgarism|vulgarismer
vulkan|vulkaner
vulva|vulvor
vurm|vurmar
vurpa|vurpor
vurre|vurrar
vuvuzela|vuvuzelor
vuxendagis|vuxendagis
vy|vyer
vykort|vykort
wakeboard|wakeboardar
walesare|walesare
walesiska|walesiskor
walkie-talkie|walkie-talkier
walkover|walkovers
wankelmotor|wankelmotorer
wannabe|wannabes
waptelefon|waptelefoner
wattimme|wattimmar
wattmeter|wattmetrar
wattsekund|wattsekunder
webbadress|webbadresser
webbanalys|webbanalyser
webbhotell|webbhotell
webbkrönika|webbkrönikor
webbläsare|webbläsare
webblogg|webbloggar
webbmejl|webbmejl
webbplats|webbplatser
webbring|webbringar
webbsajt|webbsajter
webbserver|webbservrar
webbsida|webbsidor
webbutik|webbutiker
weber|weber
weekend|weekender
Wellington|Wellingtons
wellpappkartong|wellpappkartonger
welterviktare|welterviktare
welterviktsboxare|welterviktsboxare
whiplashskada|whiplashskador
whippet|whippetar
whippetvalp|whippetvalpar
whiskybutelj|whiskybuteljer
whiskyflaska|whiskyflaskor
whiskyglas|whiskyglas
whiskygrogg|whiskygroggar
whiskypinne|whiskypinnar
whistspelare|whistspelare
wienare|wienare
wienerbröd|wienerbröd
wienerdeg|wienerdegar
wienerkorv|wienerkorvar
wienerkrans|wienerkransar
wienerschnitzel|wienerschnitzlar
wienerstol|wienerstolar
wienervals|wienervalser
wienklassicist|wienklassicister
wienska|wienskor
wigwam|wigwamer
Wii-spel|Wii-spel
wikipetter|wikipettrar
wildcard|wildcard
wilsonsimsnäppa|wilsonsimsnäppor
wiltonmatta|wiltonmattor
wobbler|wobbler
wok|wokar
wokpanna|wokpannor
worcestersås|worcestersåser
wrap|wraps
xantat|xantater
xantin|xantiner
xantippa|xantippor
xenofob|xenofober
xenofobi|xenofobier
xerofyt|xerofyter
xylofon|xylofoner
xylofonist|xylofonister
xylograf|xylografer
xylografi|xylografier
xyrofobi|xyrofobier
yngel|yngel
yngling|ynglingar
yoghurt|yoghurtar
youtubare|youtubare
yra|yror
yrke|yrken
ystning|ystningar
yta|ytor
ytterback|ytterbackar
ytterdörr|ytterdörrar
yttrande|yttranden
yuppienalle|yuppienallar
yxa|yxor
zambier|zambier
zambiska|zambiskor
zebra|zebror
zest|zests
zimbabwier|zimbabwier
zimbabwiska|zimbabwiskor
zombie|zombier
zon|zoner
zoo|zoo
zoofobi|zoofobier
zoologi|zoologier
zoonos|zoonoser
zucchini|zucchinis
zygot|zygoter